IMG,IMG NATURAL WIDTH,IMG NATURAL HEIGHT,IMG OFFSET WIDTH,IMG OFFSET HEIGHT,WIDTH DIFF,HEIGHT DIFF,CONTEXT,IMG SRC,PAGE WIDTH,PAGE URL
"=IMAGE(""https://editorial.fxstreet.com/authors/Slobodan%20Drvenica_75x75_Nano.png"")",35,35,35,35,0,0, ,https://editorial.fxstreet.com/authors/Slobodan%20Drvenica_75x75_Nano.png,360,https://www.fxstreet.com/
.fxstreet.com/
opean-union-currency-5219766_Small.jpg,360,https://www.fxstreet.com/
Small.jpg,360,https://www.fxstreet.com/
g,360,https://www.fxstreet.com/
"=IMAGE(""https://editorial.fxstreet.com/images/Resources/FMM-LogoCompleto.jpg"")",3001,1001,328,109,2673,892, ,https://editorial.fxstreet.com/images/Resources/FMM-LogoCompleto.jpg,360,https://www.fxstreet.com/info/advertising-and-sponsorship/
"=IMAGE(""https://web.archive.org/web/20220401025236im_/https://editorial.fxstreet.com/landingpages/About/broker-listing-page.jpg"")",600,448,328,245,272,203, ,https://web.archive.org/web/20220401025236im_/https://editorial.fxstreet.com/landingpages/About/broker-listing-page.jpg,360,https://www.fxstreet.com/info/advertising-and-sponsorship/
"=IMAGE(""https://web.archive.org/web/20220401025236im_/https://editorial.fxstreet.com/landingpages/About/broker-profile.jpg"")",600,448,328,245,272,203, ,https://web.archive.org/web/20220401025236im_/https://editorial.fxstreet.com/landingpages/About/broker-profile.jpg,360,https://www.fxstreet.com/info/advertising-and-sponsorship/
"=IMAGE(""https://web.archive.org/web/20220401025236im_/https://editorial.fxstreet.com/landingpages/About/home-advertising-2.jpg"")",980,512,328,171,652,341, ,https://web.archive.org/web/20220401025236im_/https://editorial.fxstreet.com/landingpages/About/home-advertising-2.jpg,360,https://www.fxstreet.com/info/advertising-and-sponsorship/
"=IMAGE(""https://web.archive.org/web/20220401025236im_/https://editorial.fxstreet.com/landingpages/About/home-advertising-2.jpg"")",980,512,328,171,652,341, ,https://web.archive.org/web/20220401025236im_/https://editorial.fxstreet.com/landingpages/About/home-advertising-2.jpg,360,https://www.fxstreet.com/info/advertising-and-sponsorship/
"=IMAGE(""https://web.archive.org/web/20220401025236im_/https://editorial.fxstreet.com/landingpages/About/languages-advertising.jpg"")",1000,338,328,110,672,228, ,https://web.archive.org/web/20220401025236im_/https://editorial.fxstreet.com/landingpages/About/languages-advertising.jpg,360,https://www.fxstreet.com/info/advertising-and-sponsorship/
"=IMAGE(""https://web.archive.org/web/20220401025236im_/https://editorial.fxstreet.com/landingpages/About/languages-advertising-1.jpg"")",650,295,328,149,322,146, ,https://web.archive.org/web/20220401025236im_/https://editorial.fxstreet.com/landingpages/About/languages-advertising-1.jpg,360,https://www.fxstreet.com/info/advertising-and-sponsorship/
"=IMAGE(""https://web.archive.org/web/20220401025236im_/https://editorial.fxstreet.com/landingpages/About/broker-listing-page-1.jpg"")",650,295,328,149,322,146, ,https://web.archive.org/web/20220401025236im_/https://editorial.fxstreet.com/landingpages/About/broker-listing-page-1.jpg,360,https://www.fxstreet.com/info/advertising-and-sponsorship/
"=IMAGE(""https://web.archive.org/web/20220401025236im_/https://editorial.fxstreet.com/landingpages/About/cryptocurrencies-countries.jpg"")",608,457,328,247,280,210, ,https://web.archive.org/web/20220401025236im_/https://editorial.fxstreet.com/landingpages/About/cryptocurrencies-countries.jpg,360,https://www.fxstreet.com/info/advertising-and-sponsorship/
"=IMAGE(""https://web.archive.org/web/20220401025236im_/https://editorial.fxstreet.com/landingpages/About/cryptocurrencies-advertising.jpg"")",1000,511,328,168,672,343, ,https://web.archive.org/web/20220401025236im_/https://editorial.fxstreet.com/landingpages/About/cryptocurrencies-advertising.jpg,360,https://www.fxstreet.com/info/advertising-and-sponsorship/
"=IMAGE(""https://web.archive.org/web/20220401025236im_/https://editorial.fxstreet.com/landingpages/About/fxs_logo_social_blueback_screen.png"")",800,746,300,280,500,466, ,https://web.archive.org/web/20220401025236im_/https://editorial.fxstreet.com/landingpages/About/fxs_logo_social_blueback_screen.png,360,https://www.fxstreet.com/info/advertising-and-sponsorship/
"=IMAGE(""https://web.archive.org/web/20220401025236im_/https://editorial.fxstreet.com/landingpages/About/email-advertising.jpg"")",299,280,299,280,0,0, ,https://web.archive.org/web/20220401025236im_/https://editorial.fxstreet.com/landingpages/About/email-advertising.jpg,360,https://www.fxstreet.com/info/advertising-and-sponsorship/
"=IMAGE(""https://web.archive.org/web/20220401025236im_/https://editorial.fxstreet.com/landingpages/About/facebook-twitter.png"")",1072,540,296,149,776,391, ,https://web.archive.org/web/20220401025236im_/https://editorial.fxstreet.com/landingpages/About/facebook-twitter.png,360,https://www.fxstreet.com/info/advertising-and-sponsorship/
"=IMAGE(""https://web.archive.org/web/20220401025236im_/https://editorial.fxstreet.com/landingpages/About/retargeting.png"")",708,732,164,170,544,562, ,https://web.archive.org/web/20220401025236im_/https://editorial.fxstreet.com/landingpages/About/retargeting.png,360,https://www.fxstreet.com/info/advertising-and-sponsorship/
"=IMAGE(""https://web.archive.org/web/20220401025236im_/https://editorial.fxstreet.com/landingpages/About/logo-tradingview.jpg"")",317,161,300,152,17,9, ,https://web.archive.org/web/20220401025236im_/https://editorial.fxstreet.com/landingpages/About/logo-tradingview.jpg,360,https://www.fxstreet.com/info/advertising-and-sponsorship/
"=IMAGE(""https://web.archive.org/web/20220401025236im_/https://editorial.fxstreet.com/landingpages/About/mediakit-tradingview.jpg"")",1070,368,328,113,742,255, ,https://web.archive.org/web/20220401025236im_/https://editorial.fxstreet.com/landingpages/About/mediakit-tradingview.jpg,360,https://www.fxstreet.com/info/advertising-and-sponsorship/
"=IMAGE(""https://web.archive.org/web/20220401025236im_/https://editorial.fxstreet.com/landingpages/About/tradingview-1.jpg"")",504,326,328,212,176,114, ,https://web.archive.org/web/20220401025236im_/https://editorial.fxstreet.com/landingpages/About/tradingview-1.jpg,360,https://www.fxstreet.com/info/advertising-and-sponsorship/
"=IMAGE(""https://web.archive.org/web/20220401025236im_/https://editorial.fxstreet.com/landingpages/About/broker-listing-page.jpg"")",600,448,328,245,272,203, ,https://web.archive.org/web/20220401025236im_/https://editorial.fxstreet.com/landingpages/About/broker-listing-page.jpg,360,https://www.fxstreet.com/info/advertising-and-sponsorship
"=IMAGE(""https://editorial.fxstreet.com/images/Resources/FMM-LogoCompleto.jpg"")",3001,1001,328,109,2673,892, ,https://editorial.fxstreet.com/images/Resources/FMM-LogoCompleto.jpg,360,https://www.fxstreet.com/info/advertising-and-sponsorship
"=IMAGE(""https://web.archive.org/web/20220401025236im_/https://editorial.fxstreet.com/landingpages/About/broker-profile.jpg"")",600,448,328,245,272,203, ,https://web.archive.org/web/20220401025236im_/https://editorial.fxstreet.com/landingpages/About/broker-profile.jpg,360,https://www.fxstreet.com/info/advertising-and-sponsorship
"=IMAGE(""https://web.archive.org/web/20220401025236im_/https://editorial.fxstreet.com/landingpages/About/home-advertising-2.jpg"")",980,512,328,171,652,341, ,https://web.archive.org/web/20220401025236im_/https://editorial.fxstreet.com/landingpages/About/home-advertising-2.jpg,360,https://www.fxstreet.com/info/advertising-and-sponsorship
"=IMAGE(""https://web.archive.org/web/20220401025236im_/https://editorial.fxstreet.com/landingpages/About/home-advertising-2.jpg"")",980,512,328,171,652,341, ,https://web.archive.org/web/20220401025236im_/https://editorial.fxstreet.com/landingpages/About/home-advertising-2.jpg,360,https://www.fxstreet.com/info/advertising-and-sponsorship
"=IMAGE(""https://web.archive.org/web/20220401025236im_/https://editorial.fxstreet.com/landingpages/About/languages-advertising.jpg"")",1000,338,328,110,672,228, ,https://web.archive.org/web/20220401025236im_/https://editorial.fxstreet.com/landingpages/About/languages-advertising.jpg,360,https://www.fxstreet.com/info/advertising-and-sponsorship
"=IMAGE(""https://web.archive.org/web/20220401025236im_/https://editorial.fxstreet.com/landingpages/About/broker-listing-page-1.jpg"")",650,295,328,149,322,146, ,https://web.archive.org/web/20220401025236im_/https://editorial.fxstreet.com/landingpages/About/broker-listing-page-1.jpg,360,https://www.fxstreet.com/info/advertising-and-sponsorship
"=IMAGE(""https://web.archive.org/web/20220401025236im_/https://editorial.fxstreet.com/landingpages/About/cryptocurrencies-countries.jpg"")",608,457,328,247,280,210, ,https://web.archive.org/web/20220401025236im_/https://editorial.fxstreet.com/landingpages/About/cryptocurrencies-countries.jpg,360,https://www.fxstreet.com/info/advertising-and-sponsorship
"=IMAGE(""https://web.archive.org/web/20220401025236im_/https://editorial.fxstreet.com/landingpages/About/fxs_logo_social_blueback_screen.png"")",800,746,300,280,500,466, ,https://web.archive.org/web/20220401025236im_/https://editorial.fxstreet.com/landingpages/About/fxs_logo_social_blueback_screen.png,360,https://www.fxstreet.com/info/advertising-and-sponsorship
"=IMAGE(""https://web.archive.org/web/20220401025236im_/https://editorial.fxstreet.com/landingpages/About/cryptocurrencies-advertising.jpg"")",1000,511,328,168,672,343, ,https://web.archive.org/web/20220401025236im_/https://editorial.fxstreet.com/landingpages/About/cryptocurrencies-advertising.jpg,360,https://www.fxstreet.com/info/advertising-and-sponsorship
"=IMAGE(""https://web.archive.org/web/20220401025236im_/https://editorial.fxstreet.com/landingpages/About/email-advertising.jpg"")",299,280,299,280,0,0, ,https://web.archive.org/web/20220401025236im_/https://editorial.fxstreet.com/landingpages/About/email-advertising.jpg,360,https://www.fxstreet.com/info/advertising-and-sponsorship
"=IMAGE(""https://web.archive.org/web/20220401025236im_/https://editorial.fxstreet.com/landingpages/About/facebook-twitter.png"")",1072,540,296,149,776,391, ,https://web.archive.org/web/20220401025236im_/https://editorial.fxstreet.com/landingpages/About/facebook-twitter.png,360,https://www.fxstreet.com/info/advertising-and-sponsorship
"=IMAGE(""https://web.archive.org/web/20220401025236im_/https://editorial.fxstreet.com/landingpages/About/languages-advertising-1.jpg"")",650,295,328,149,322,146, ,https://web.archive.org/web/20220401025236im_/https://editorial.fxstreet.com/landingpages/About/languages-advertising-1.jpg,360,https://www.fxstreet.com/info/advertising-and-sponsorship
"=IMAGE(""https://web.archive.org/web/20220401025236im_/https://editorial.fxstreet.com/landingpages/About/retargeting.png"")",708,732,164,170,544,562, ,https://web.archive.org/web/20220401025236im_/https://editorial.fxstreet.com/landingpages/About/retargeting.png,360,https://www.fxstreet.com/info/advertising-and-sponsorship
"=IMAGE(""https://web.archive.org/web/20220401025236im_/https://editorial.fxstreet.com/landingpages/About/logo-tradingview.jpg"")",317,161,300,152,17,9, ,https://web.archive.org/web/20220401025236im_/https://editorial.fxstreet.com/landingpages/About/logo-tradingview.jpg,360,https://www.fxstreet.com/info/advertising-and-sponsorship
"=IMAGE(""https://web.archive.org/web/20220401025236im_/https://editorial.fxstreet.com/landingpages/About/mediakit-tradingview.jpg"")",1070,368,328,113,742,255, ,https://web.archive.org/web/20220401025236im_/https://editorial.fxstreet.com/landingpages/About/mediakit-tradingview.jpg,360,https://www.fxstreet.com/info/advertising-and-sponsorship
"=IMAGE(""https://web.archive.org/web/20220401025236im_/https://editorial.fxstreet.com/landingpages/About/tradingview-1.jpg"")",504,326,328,212,176,114, ,https://web.archive.org/web/20220401025236im_/https://editorial.fxstreet.com/landingpages/About/tradingview-1.jpg,360,https://www.fxstreet.com/info/advertising-and-sponsorship
"=IMAGE(""
https://editorial.fxstreet.com/landingpages/About/fxs_logo_social_blueback_screen.png"")",800,746,328,306,472,440, ,"
https://editorial.fxstreet.com/landingpages/About/fxs_logo_social_blueback_screen.png",360,https://www.fxstreet.com/info/corporate-identity
"=IMAGE(""https://editorial.fxstreet.com/landingpages/About/fxs_logo_whiteback_screen.png"")",1500,524,328,115,1172,409, ,https://editorial.fxstreet.com/landingpages/About/fxs_logo_whiteback_screen.png,360,https://www.fxstreet.com/info/corporate-identity
"=IMAGE(""
https://editorial.fxstreet.com/landingpages/About/fxs_logo_social_whiteeback.png"")",870,756,328,285,542,471, ,"
https://editorial.fxstreet.com/landingpages/About/fxs_logo_social_whiteeback.png",360,https://www.fxstreet.com/info/corporate-identity
"=IMAGE(""https://editorial.fxstreet.com/landingpages/About/fxs_logo_transparent.png"")",1500,524,328,115,1172,409, ,https://editorial.fxstreet.com/landingpages/About/fxs_logo_transparent.png,360,https://www.fxstreet.com/info/corporate-identity
"=IMAGE(""https://editorial.fxstreet.com/landingpages/About/fxs_logo_blueback_screen.png"")",1500,524,328,115,1172,409, ,https://editorial.fxstreet.com/landingpages/About/fxs_logo_blueback_screen.png,360,https://www.fxstreet.com/info/corporate-identity
"=IMAGE(""https://editorial.fxstreet.com/images/Markets/Currencies/Majors/EURUSD/euro-or-dollar-3353142_XtraSmall.jpg"")",125,83,95,63,30,20, ,https://editorial.fxstreet.com/images/Markets/Currencies/Majors/EURUSD/euro-or-dollar-3353142_XtraSmall.jpg,360,https://www.fxstreet.com/rates-charts/forecast
"=IMAGE(""https://editorial.fxstreet.com/images/Markets/Currencies/Majors/USDJPY/close-up-bank-note-of-japanese-5000-yen-44653096_XtraSmall.jpg"")",125,83,95,63,30,20, ,https://editorial.fxstreet.com/images/Markets/Currencies/Majors/USDJPY/close-up-bank-note-of-japanese-5000-yen-44653096_XtraSmall.jpg,360,https://www.fxstreet.com/rates-charts/forecast
"=IMAGE(""https://editorial.fxstreet.com/images/Markets/Currencies/Majors/GBPUSD/iStock-1178148633_XtraSmall.jpg"")",125,83,95,63,30,20, ,https://editorial.fxstreet.com/images/Markets/Currencies/Majors/GBPUSD/iStock-1178148633_XtraSmall.jpg,360,https://www.fxstreet.com/rates-charts/forecast
"=IMAGE(""https://editorial.fxstreet.com/images/Markets/Currencies/Digital%20Currencies/Bitcoin/bitcoins-37949586_XtraSmall.jpg"")",125,83,95,63,30,20, ,https://editorial.fxstreet.com/images/Markets/Currencies/Digital%20Currencies/Bitcoin/bitcoins-37949586_XtraSmall.jpg,360,https://www.fxstreet.com/rates-charts/forecast
"=IMAGE(""https://editorial.fxstreet.com/images/Markets/Currencies/Majors/AUDUSD/australian-money-15191644_XtraSmall.jpg"")",125,97,95,74,30,23, ,https://editorial.fxstreet.com/images/Markets/Currencies/Majors/AUDUSD/australian-money-15191644_XtraSmall.jpg,360,https://www.fxstreet.com/rates-charts/forecast
"=IMAGE(""https://editorial.fxstreet.com/images/Markets/Commodities/Metals/Gold/safe-investment-gm147311616-17537479_XtraSmall.jpg"")",125,94,95,71,30,23, ,https://editorial.fxstreet.com/images/Markets/Commodities/Metals/Gold/safe-investment-gm147311616-17537479_XtraSmall.jpg,360,https://www.fxstreet.com/rates-charts/forecast
"=IMAGE(""https://editorial.fxstreet.com/images/Markets/Currencies/Majors/EURUSD/MoneyEURUSD_2_XtraSmall.jpg"")",125,83,92,61,33,22, ,https://editorial.fxstreet.com/images/Markets/Currencies/Majors/EURUSD/MoneyEURUSD_2_XtraSmall.jpg,360,https://www.fxstreet.com/rates-charts/usdchf
"=IMAGE(""https://editorial.fxstreet.com/images/Markets/Currencies/Cryptocurrencies/keyboard-637516572906741132_XtraSmall.jpg"")",125,83,92,61,33,22, ,https://editorial.fxstreet.com/images/Markets/Currencies/Cryptocurrencies/keyboard-637516572906741132_XtraSmall.jpg,360,https://www.fxstreet.com/rates-charts/usdchf
"=IMAGE(""https://editorial.fxstreet.com/images/Markets/Commodities/Metals/Gold/gold-on-weight-scale-gm165418687-21879510_XtraSmall.jpg"")",125,83,92,61,33,22, ,https://editorial.fxstreet.com/images/Markets/Commodities/Metals/Gold/gold-on-weight-scale-gm165418687-21879510_XtraSmall.jpg,360,https://www.fxstreet.com/rates-charts/usdchf
"=IMAGE(""https://editorial.fxstreet.com/images/Markets/Currencies/Majors/USDJPY/japanese-yen3_Nano.jpg"")",75,50,75,50,0,0, ,https://editorial.fxstreet.com/images/Markets/Currencies/Majors/USDJPY/japanese-yen3_Nano.jpg,360,https://www.fxstreet.com/rates-charts/usdchf
"=IMAGE(""https://editorial.fxstreet.com/images/Macroeconomics/EconomicIndicator/EconomicHealth/Manufacturing/production-line-workers-gm519937869-50154370_Nano.jpg"")",70,47,74,50,-4,-3, ,https://editorial.fxstreet.com/images/Macroeconomics/EconomicIndicator/EconomicHealth/Manufacturing/production-line-workers-gm519937869-50154370_Nano.jpg,360,https://www.fxstreet.com/rates-charts/usdchf
"=IMAGE(""https://editorial.fxstreet.com/images/Markets/Currencies/Cryptocurrencies/AxieInfinity/AxieInfinity_Nano.jpg"")",75,75,50,50,25,25, ,https://editorial.fxstreet.com/images/Markets/Currencies/Cryptocurrencies/AxieInfinity/AxieInfinity_Nano.jpg,360,https://www.fxstreet.com/rates-charts/usdchf
"=IMAGE(""https://editorial.fxstreet.com/images/Markets/Currencies/Cryptocurrencies/Crypto.com/cryptocom-150x150logo-637399977312067518_Nano.png"")",75,75,50,50,25,25, ,https://editorial.fxstreet.com/images/Markets/Currencies/Cryptocurrencies/Crypto.com/cryptocom-150x150logo-637399977312067518_Nano.png,360,https://www.fxstreet.com/rates-charts/usdchf
"=IMAGE(""https://editorial.fxstreet.com/images/Markets/Currencies/Cryptocurrencies/cryptos_Nano.jpg"")",75,50,75,50,0,0, ,https://editorial.fxstreet.com/images/Markets/Currencies/Cryptocurrencies/cryptos_Nano.jpg,360,https://www.fxstreet.com/rates-charts/usdchf
"=IMAGE(""https://editorial.fxstreet.com/authors/Slobodan%20Drvenica_75x75_XtraSmall.png"")",75,75,50,50,25,25, ,https://editorial.fxstreet.com/authors/Slobodan%20Drvenica_75x75_XtraSmall.png,360,https://www.fxstreet.com/rates-charts/usdchf
"=IMAGE(""https://editorial.fxstreet.com/authors/Bert%20Colijn%2075_XtraSmall.png"")",75,75,50,50,25,25, ,https://editorial.fxstreet.com/authors/Bert%20Colijn%2075_XtraSmall.png,360,https://www.fxstreet.com/rates-charts/usdchf
"=IMAGE(""https://editorial.fxstreet.com/authors/Slobodan%20Drvenica_75x75_XtraSmall.png"")",75,75,50,50,25,25, ,https://editorial.fxstreet.com/authors/Slobodan%20Drvenica_75x75_XtraSmall.png,360,https://www.fxstreet.com/rates-charts/usdchf
"=IMAGE(""https://editorial.fxstreet.com/images/Markets/Currencies/Majors/GBPUSD/iStock-689067954_XtraSmall.jpg"")",125,83,92,61,33,22, ,https://editorial.fxstreet.com/images/Markets/Currencies/Majors/GBPUSD/iStock-689067954_XtraSmall.jpg,360,https://www.fxstreet.com/rates-charts/usdchf
"=IMAGE(""https://editorial.fxstreet.com/images/Markets/Currencies/Majors/NZDUSD/new-zealand-dollar-closeup-28405768_Nano.jpg"")",75,49,77,50,-2,-1, ,https://editorial.fxstreet.com/images/Markets/Currencies/Majors/NZDUSD/new-zealand-dollar-closeup-28405768_Nano.jpg,360,https://www.fxstreet.com/rates-charts/usdchf
"=IMAGE(""https://editorial.fxstreet.com/images/Resources/Always_On_Editors_Pick_(320x213)_XtraSmall.png"")",125,83,92,61,33,22, ,https://editorial.fxstreet.com/images/Resources/Always_On_Editors_Pick_(320x213)_XtraSmall.png,360,https://www.fxstreet.com/rates-charts/usdchf
"=IMAGE(""https://editorial.fxstreet.com/authors/kathleen-books-author-photoMedium_XtraSmall.jpg"")",75,74,50,50,25,24, ,https://editorial.fxstreet.com/authors/kathleen-books-author-photoMedium_XtraSmall.jpg,360,https://www.fxstreet.com/analysis/indices-insider/2015/01/15/03
"=IMAGE(""https://oldfxstreetbackups.blob.core.windows.net/reports/dd7a327c-e31a-447d-a1ce-93d5ea45a7c9/un_20150115103046.png"")",1000,555,328,182,672,373, ,https://oldfxstreetbackups.blob.core.windows.net/reports/dd7a327c-e31a-447d-a1ce-93d5ea45a7c9/un_20150115103046.png,360,https://www.fxstreet.com/analysis/indices-insider/2015/01/15/03
"=IMAGE(""https://oldfxstreetbackups.blob.core.windows.net/reports/dd7a327c-e31a-447d-a1ce-93d5ea45a7c9/analysis-646x40_20140224095250.gif"")",646,40,328,20,318,20, ,https://oldfxstreetbackups.blob.core.windows.net/reports/dd7a327c-e31a-447d-a1ce-93d5ea45a7c9/analysis-646x40_20140224095250.gif,360,https://www.fxstreet.com/analysis/indices-insider/2015/01/15/03
"=IMAGE(""https://editorial.fxstreet.com/images/Markets/Currencies/Majors/GBPUSD/iStock-689067954_XtraSmall.jpg"")",125,83,92,61,33,22, ,https://editorial.fxstreet.com/images/Markets/Currencies/Majors/GBPUSD/iStock-689067954_XtraSmall.jpg,360,https://www.fxstreet.com/analysis/indices-insider/2015/01/15/03
"=IMAGE(""https://editorial.fxstreet.com/images/Markets/Commodities/Metals/Gold/gold-on-weight-scale-gm165418687-21879510_XtraSmall.jpg"")",125,83,92,61,33,22, ,https://editorial.fxstreet.com/images/Markets/Commodities/Metals/Gold/gold-on-weight-scale-gm165418687-21879510_XtraSmall.jpg,360,https://www.fxstreet.com/analysis/indices-insider/2015/01/15/03
"=IMAGE(""https://editorial.fxstreet.com/images/Markets/Currencies/Cryptocurrencies/keyboard-637516572906741132_XtraSmall.jpg"")",125,83,92,61,33,22, ,https://editorial.fxstreet.com/images/Markets/Currencies/Cryptocurrencies/keyboard-637516572906741132_XtraSmall.jpg,360,https://www.fxstreet.com/analysis/indices-insider/2015/01/15/03
"=IMAGE(""https://editorial.fxstreet.com/images/Markets/Currencies/Majors/USDJPY/close-up-bank-note-of-japanese-5000-yen-44653096_Nano.jpg"")",75,50,75,50,0,0, ,https://editorial.fxstreet.com/images/Markets/Currencies/Majors/USDJPY/close-up-bank-note-of-japanese-5000-yen-44653096_Nano.jpg,360,https://www.fxstreet.com/analysis/indices-insider/2015/01/15/03
"=IMAGE(""https://editorial.fxstreet.com/images/Macroeconomics/EconomicIndicator/EconomicHealth/GDP/Growth/businessman-calculating-tax-with-coins-at-desk-gm503897740-82845157_Nano.jpg"")",70,47,74,50,-4,-3, ,https://editorial.fxstreet.com/images/Macroeconomics/EconomicIndicator/EconomicHealth/GDP/Growth/businessman-calculating-tax-with-coins-at-desk-gm503897740-82845157_Nano.jpg,360,https://www.fxstreet.com/analysis/indices-insider/2015/01/15/03
"=IMAGE(""https://editorial.fxstreet.com/images/Markets/Currencies/Majors/NZDUSD/new-zealand-dollar-61366114_Nano.jpg"")",75,50,75,50,0,0, ,https://editorial.fxstreet.com/images/Markets/Currencies/Majors/NZDUSD/new-zealand-dollar-61366114_Nano.jpg,360,https://www.fxstreet.com/analysis/indices-insider/2015/01/15/03
"=IMAGE(""https://editorial.fxstreet.com/images/Markets/Currencies/Digital Currencies/Ethereum/ethereum_2_Nano.jpg"")",75,56,67,50,8,6, ,https://editorial.fxstreet.com/images/Markets/Currencies/Digital Currencies/Ethereum/ethereum_2_Nano.jpg,360,https://www.fxstreet.com/analysis/indices-insider/2015/01/15/03
"=IMAGE(""https://editorial.fxstreet.com/images/Resources/Always_On_Editors_Pick_(320x213)_XtraSmall.png"")",125,83,92,61,33,22, ,https://editorial.fxstreet.com/images/Resources/Always_On_Editors_Pick_(320x213)_XtraSmall.png,360,https://www.fxstreet.com/analysis/indices-insider/2015/01/15/03
"=IMAGE(""https://editorial.fxstreet.com/images/Macroeconomics/MonetaryPolicy/FED/the-federal-reserve-building-in-washington-dc-usa-67160227_Nano.jpg"")",75,50,75,50,0,0, ,https://editorial.fxstreet.com/images/Macroeconomics/MonetaryPolicy/FED/the-federal-reserve-building-in-washington-dc-usa-67160227_Nano.jpg,360,https://www.fxstreet.com/analysis/indices-insider/2015/01/15/03
"=IMAGE(""https://editorial.fxstreet.com/images/Markets/Currencies/Majors/EURUSD/MoneyEURUSD_2_XtraSmall.jpg"")",125,83,92,61,33,22, ,https://editorial.fxstreet.com/images/Markets/Currencies/Majors/EURUSD/MoneyEURUSD_2_XtraSmall.jpg,360,https://www.fxstreet.com/analysis/indices-insider/2015/01/15/03
"=IMAGE(""https://editorial.fxstreet.com/authors/Ivan_Brian_75x75-637460415014970981_XtraSmall.jpg"")",75,75,50,50,25,25, ,https://editorial.fxstreet.com/authors/Ivan_Brian_75x75-637460415014970981_XtraSmall.jpg,360,https://www.fxstreet.com/analysis/indices-insider/2015/01/15/03
"=IMAGE(""https://editorial.fxstreet.com/images/Markets/Currencies/Cryptocurrencies/cryptos_Nano.jpg"")",75,50,75,50,0,0, ,https://editorial.fxstreet.com/images/Markets/Currencies/Cryptocurrencies/cryptos_Nano.jpg,360,https://www.fxstreet.com/analysis/indices-insider/2015/01/15/03
"=IMAGE(""https://editorial.fxstreet.com/authors/Slobodan%20Drvenica_75x75_XtraSmall.png"")",75,75,50,50,25,25, ,https://editorial.fxstreet.com/authors/Slobodan%20Drvenica_75x75_XtraSmall.png,360,https://www.fxstreet.com/analysis/indices-insider/2015/01/15/03
"=IMAGE(""https://editorial.fxstreet.com/authors/Ivan_Brian_75x75-637460415014970981_XtraSmall.jpg"")",75,75,50,50,25,25, ,https://editorial.fxstreet.com/authors/Ivan_Brian_75x75-637460415014970981_XtraSmall.jpg,360,https://www.fxstreet.com/analysis/indices-insider/2015/01/15/03
"=IMAGE(""https://editorial.fxstreet.com/authors/Ivan_Brian_75x75-637460415014970981_XtraSmall.jpg"")",75,75,50,50,25,25, ,https://editorial.fxstreet.com/authors/Ivan_Brian_75x75-637460415014970981_XtraSmall.jpg,360,https://www.fxstreet.com/news/spdr-sp-500-etf-spy-news-and-forecast-is-the-rally-over-202206011236
"=IMAGE(""https://editorial.fxstreet.com/images/Markets/Currencies/Majors/EURUSD/MoneyEURUSD_2_XtraSmall.jpg"")",125,83,92,61,33,22, ,https://editorial.fxstreet.com/images/Markets/Currencies/Majors/EURUSD/MoneyEURUSD_2_XtraSmall.jpg,360,https://www.fxstreet.com/news/spdr-sp-500-etf-spy-news-and-forecast-is-the-rally-over-202206011236
"=IMAGE(""https://editorial.fxstreet.com/images/Markets/Currencies/Majors/GBPUSD/iStock-689067954_XtraSmall.jpg"")",125,83,92,61,33,22, ,https://editorial.fxstreet.com/images/Markets/Currencies/Majors/GBPUSD/iStock-689067954_XtraSmall.jpg,360,https://www.fxstreet.com/news/spdr-sp-500-etf-spy-news-and-forecast-is-the-rally-over-202206011236
"=IMAGE(""https://editorial.fxstreet.com/images/Markets/Commodities/Metals/Gold/gold-on-weight-scale-gm165418687-21879510_XtraSmall.jpg"")",125,83,92,61,33,22, ,https://editorial.fxstreet.com/images/Markets/Commodities/Metals/Gold/gold-on-weight-scale-gm165418687-21879510_XtraSmall.jpg,360,https://www.fxstreet.com/news/spdr-sp-500-etf-spy-news-and-forecast-is-the-rally-over-202206011236
"=IMAGE(""https://editorial.fxstreet.com/images/Markets/Currencies/Cryptocurrencies/keyboard-637516572906741132_XtraSmall.jpg"")",125,83,92,61,33,22, ,https://editorial.fxstreet.com/images/Markets/Currencies/Cryptocurrencies/keyboard-637516572906741132_XtraSmall.jpg,360,https://www.fxstreet.com/news/spdr-sp-500-etf-spy-news-and-forecast-is-the-rally-over-202206011236
"=IMAGE(""https://editorial.fxstreet.com/images/Resources/Always_On_Editors_Pick_(320x213)_XtraSmall.png"")",125,83,92,61,33,22, ,https://editorial.fxstreet.com/images/Resources/Always_On_Editors_Pick_(320x213)_XtraSmall.png,360,https://www.fxstreet.com/news/spdr-sp-500-etf-spy-news-and-forecast-is-the-rally-over-202206011236
"=IMAGE(""https://editorial.fxstreet.com/miscelaneous/image-637896826798625552.png"")",1585,899,328,482,1257,417, ,https://editorial.fxstreet.com/miscelaneous/image-637896826798625552.png,360,https://www.fxstreet.com/news/spdr-sp-500-etf-spy-news-and-forecast-is-the-rally-over-202206011236
"=IMAGE(""https://editorial.fxstreet.com/authors/Ivan_Brian_75x75-637460415014970981_XtraSmall.jpg"")",75,75,50,50,25,25, ,https://editorial.fxstreet.com/authors/Ivan_Brian_75x75-637460415014970981_XtraSmall.jpg,360,https://www.fxstreet.com/news/tesla-stock-deep-dive-price-target-at-400-on-china-headwinds-margin-compression-lower-deliveries-202205261030
"=IMAGE(""https://editorial.fxstreet.com/miscelaneous/image-637889916415354052.png"")",1170,479,328,134,842,345, ,https://editorial.fxstreet.com/miscelaneous/image-637889916415354052.png,360,https://www.fxstreet.com/news/tesla-stock-deep-dive-price-target-at-400-on-china-headwinds-margin-compression-lower-deliveries-202205261030
"=IMAGE(""https://editorial.fxstreet.com/miscelaneous/TSLA (1)-637891492321522346.png"")",1707,736,328,366,1379,370, ,https://editorial.fxstreet.com/miscelaneous/TSLA (1)-637891492321522346.png,360,https://www.fxstreet.com/news/tesla-stock-deep-dive-price-target-at-400-on-china-headwinds-margin-compression-lower-deliveries-202205261030
"=IMAGE(""https://editorial.fxstreet.com/images/Markets/Currencies/Majors/EURUSD/MoneyEURUSD_2_XtraSmall.jpg"")",125,83,92,61,33,22, ,https://editorial.fxstreet.com/images/Markets/Currencies/Majors/EURUSD/MoneyEURUSD_2_XtraSmall.jpg,360,https://www.fxstreet.com/news/tesla-stock-deep-dive-price-target-at-400-on-china-headwinds-margin-compression-lower-deliveries-202205261030
"=IMAGE(""https://editorial.fxstreet.com/miscelaneous/TSLA-637889898178624635.png"")",1885,919,328,414,1557,505, ,https://editorial.fxstreet.com/miscelaneous/TSLA-637889898178624635.png,360,https://www.fxstreet.com/news/tesla-stock-deep-dive-price-target-at-400-on-china-headwinds-margin-compression-lower-deliveries-202205261030
"=IMAGE(""https://editorial.fxstreet.com/images/Markets/Currencies/Majors/GBPUSD/iStock-689067954_XtraSmall.jpg"")",125,83,92,61,33,22, ,https://editorial.fxstreet.com/images/Markets/Currencies/Majors/GBPUSD/iStock-689067954_XtraSmall.jpg,360,https://www.fxstreet.com/news/tesla-stock-deep-dive-price-target-at-400-on-china-headwinds-margin-compression-lower-deliveries-202205261030
"=IMAGE(""https://editorial.fxstreet.com/images/Markets/Commodities/Metals/Gold/gold-on-weight-scale-gm165418687-21879510_XtraSmall.jpg"")",125,83,92,61,33,22, ,https://editorial.fxstreet.com/images/Markets/Commodities/Metals/Gold/gold-on-weight-scale-gm165418687-21879510_XtraSmall.jpg,360,https://www.fxstreet.com/news/tesla-stock-deep-dive-price-target-at-400-on-china-headwinds-margin-compression-lower-deliveries-202205261030
"=IMAGE(""https://editorial.fxstreet.com/miscelaneous/image-637891518461865499.png"")",1585,899,328,482,1257,417, ,https://editorial.fxstreet.com/miscelaneous/image-637891518461865499.png,360,https://www.fxstreet.com/news/tesla-stock-deep-dive-price-target-at-400-on-china-headwinds-margin-compression-lower-deliveries-202205261030
"=IMAGE(""https://editorial.fxstreet.com/images/Resources/Always_On_Editors_Pick_(320x213)_XtraSmall.png"")",125,83,92,61,33,22, ,https://editorial.fxstreet.com/images/Resources/Always_On_Editors_Pick_(320x213)_XtraSmall.png,360,https://www.fxstreet.com/news/tesla-stock-deep-dive-price-target-at-400-on-china-headwinds-margin-compression-lower-deliveries-202205261030
"=IMAGE(""https://editorial.fxstreet.com/images/Markets/Currencies/Cryptocurrencies/keyboard-637516572906741132_XtraSmall.jpg"")",125,83,92,61,33,22, ,https://editorial.fxstreet.com/images/Markets/Currencies/Cryptocurrencies/keyboard-637516572906741132_XtraSmall.jpg,360,https://www.fxstreet.com/news/tesla-stock-deep-dive-price-target-at-400-on-china-headwinds-margin-compression-lower-deliveries-202205261030
"=IMAGE(""https://editorial.fxstreet.com/miscelaneous/image-637891517717807279.png"")",1585,899,328,482,1257,417, ,https://editorial.fxstreet.com/miscelaneous/image-637891517717807279.png,360,https://www.fxstreet.com/news/tesla-stock-deep-dive-price-target-at-400-on-china-headwinds-margin-compression-lower-deliveries-202205261030
"=IMAGE(""https://editorial.fxstreet.com/authors/Ivan_Brian_75x75-637460415014970981_XtraSmall.jpg"")",75,75,50,50,25,25, ,https://editorial.fxstreet.com/authors/Ivan_Brian_75x75-637460415014970981_XtraSmall.jpg,360,https://www.fxstreet.com/news/gores-guggenheim-stock-news-and-forecast-ggpi-stock-sets-june-22-to-approve-polestar-merger-202205261217
"=IMAGE(""https://editorial.fxstreet.com/miscelaneous/image-637891577514731060.png"")",1585,899,328,482,1257,417, ,https://editorial.fxstreet.com/miscelaneous/image-637891577514731060.png,360,https://www.fxstreet.com/news/gores-guggenheim-stock-news-and-forecast-ggpi-stock-sets-june-22-to-approve-polestar-merger-202205261217
"=IMAGE(""https://editorial.fxstreet.com/images/Markets/Currencies/Majors/GBPUSD/iStock-689067954_XtraSmall.jpg"")",125,83,92,61,33,22, ,https://editorial.fxstreet.com/images/Markets/Currencies/Majors/GBPUSD/iStock-689067954_XtraSmall.jpg,360,https://www.fxstreet.com/news/gores-guggenheim-stock-news-and-forecast-ggpi-stock-sets-june-22-to-approve-polestar-merger-202205261217
"=IMAGE(""https://editorial.fxstreet.com/images/Markets/Commodities/Metals/Gold/gold-on-weight-scale-gm165418687-21879510_XtraSmall.jpg"")",125,83,92,61,33,22, ,https://editorial.fxstreet.com/images/Markets/Commodities/Metals/Gold/gold-on-weight-scale-gm165418687-21879510_XtraSmall.jpg,360,https://www.fxstreet.com/news/gores-guggenheim-stock-news-and-forecast-ggpi-stock-sets-june-22-to-approve-polestar-merger-202205261217
"=IMAGE(""https://editorial.fxstreet.com/images/Markets/Currencies/Cryptocurrencies/keyboard-637516572906741132_XtraSmall.jpg"")",125,83,92,61,33,22, ,https://editorial.fxstreet.com/images/Markets/Currencies/Cryptocurrencies/keyboard-637516572906741132_XtraSmall.jpg,360,https://www.fxstreet.com/news/gores-guggenheim-stock-news-and-forecast-ggpi-stock-sets-june-22-to-approve-polestar-merger-202205261217
"=IMAGE(""https://editorial.fxstreet.com/images/Markets/Currencies/Majors/EURUSD/MoneyEURUSD_2_XtraSmall.jpg"")",125,83,92,61,33,22, ,https://editorial.fxstreet.com/images/Markets/Currencies/Majors/EURUSD/MoneyEURUSD_2_XtraSmall.jpg,360,https://www.fxstreet.com/news/gores-guggenheim-stock-news-and-forecast-ggpi-stock-sets-june-22-to-approve-polestar-merger-202205261217
"=IMAGE(""https://editorial.fxstreet.com/images/Resources/Always_On_Editors_Pick_(320x213)_XtraSmall.png"")",125,83,92,61,33,22, ,https://editorial.fxstreet.com/images/Resources/Always_On_Editors_Pick_(320x213)_XtraSmall.png,360,https://www.fxstreet.com/news/gores-guggenheim-stock-news-and-forecast-ggpi-stock-sets-june-22-to-approve-polestar-merger-202205261217
"=IMAGE(""https://responsive.fxempire.com/width/274x90/webp-lossy-70.q50/_fximages_/logos/xm-100.png"")",274,91,70,20,204,71, ,https://responsive.fxempire.com/width/274x90/webp-lossy-70.q50/_fximages_/logos/xm-100.png,360,https://www.fxstreet.com/amp/news/gores-guggenheim-stock-news-and-forecast-ggpi-stock-sets-june-22-to-approve-polestar-merger-202205261217
"=IMAGE(""https://editorial.fxstreet.com/images/Markets/Equities/Nasdaq/yellow-taxi-in-times-square-of-new-york-city-manhattan-29728130_Small.jpg"")",320,213,328,216,-8,-3, ,https://editorial.fxstreet.com/images/Markets/Equities/Nasdaq/yellow-taxi-in-times-square-of-new-york-city-manhattan-29728130_Small.jpg,360,https://www.fxstreet.com/amp/news/gores-guggenheim-stock-news-and-forecast-ggpi-stock-sets-june-22-to-approve-polestar-merger-202205261217
"=IMAGE(""https://editorial.fxstreet.com/miscelaneous/image-637891577514731060.png"")",1585,899,328,186,1257,713, ,https://editorial.fxstreet.com/miscelaneous/image-637891577514731060.png,360,https://www.fxstreet.com/amp/news/gores-guggenheim-stock-news-and-forecast-ggpi-stock-sets-june-22-to-approve-polestar-merger-202205261217
"=IMAGE(""https://editorial.fxstreet.com/images/Others/App/app-download-apple-1.png"")",300,111,0,0,300,111, ,https://editorial.fxstreet.com/images/Others/App/app-download-apple-1.png,360,https://www.fxstreet.com/economic-calendar/united-states
"=IMAGE(""https://editorial.fxstreet.com/images/Others/App/app-download-google-1.png"")",300,111,0,0,300,111, ,https://editorial.fxstreet.com/images/Others/App/app-download-google-1.png,360,https://www.fxstreet.com/economic-calendar/united-states
"=IMAGE(""https://editorial.fxstreet.com/authors/Stefan%20Gleason_XtraSmall.jpg"")",75,75,50,50,25,25, ,https://editorial.fxstreet.com/authors/Stefan%20Gleason_XtraSmall.jpg,360,https://www.fxstreet.com/economic-calendar/united-states
"=IMAGE(""https://editorial.fxstreet.com/authors/AntonKolhanov%2075_XtraSmall.jpg"")",75,75,50,50,25,25, ,https://editorial.fxstreet.com/authors/AntonKolhanov%2075_XtraSmall.jpg,360,https://www.fxstreet.com/economic-calendar/united-states
"=IMAGE(""https://editorial.fxstreet.com/miscelaneous/Economic Calendar - FXStreet (4)-637086490478019934.png"")",113,30,80,22,33,8, ,https://editorial.fxstreet.com/miscelaneous/Economic Calendar - FXStreet (4)-637086490478019934.png,360,https://www.fxstreet.com/economic-calendar/united-states
"=IMAGE(""https://editorial.fxstreet.com/authors/team_XtraSmall.png"")",74,75,50,50,24,25, ,https://editorial.fxstreet.com/authors/team_XtraSmall.png,360,https://www.fxstreet.com/economic-calendar/united-states
"=IMAGE(""https://editorial.fxstreet.com/authors/team_XtraSmall.png"")",74,75,50,50,24,25, ,https://editorial.fxstreet.com/authors/team_XtraSmall.png,360,https://www.fxstreet.com/economic-calendar/united-states
"=IMAGE(""https://editorial.fxstreet.com/authors/team_XtraSmall.png"")",74,75,50,50,24,25, ,https://editorial.fxstreet.com/authors/team_XtraSmall.png,360,https://www.fxstreet.com/economic-calendar/united-states
"=IMAGE(""https://editorial.fxstreet.com/authors/Kenny%20Polcari_XtraSmall.jpg"")",75,75,50,50,25,25, ,https://editorial.fxstreet.com/authors/Kenny%20Polcari_XtraSmall.jpg,360,https://www.fxstreet.com/macroeconomics/central-banks/fed
"=IMAGE(""https://editorial.fxstreet.com/authors/CliffordBennett_75_XtraSmall.jpg"")",75,75,50,50,25,25, ,https://editorial.fxstreet.com/authors/CliffordBennett_75_XtraSmall.jpg,360,https://www.fxstreet.com/macroeconomics/central-banks/fed
"=IMAGE(""https://editorial.fxstreet.com/authors/JacobWolinsky75_XtraSmall.png"")",75,75,50,50,25,25, ,https://editorial.fxstreet.com/authors/JacobWolinsky75_XtraSmall.png,360,https://www.fxstreet.com/macroeconomics/central-banks/fed
"=IMAGE(""https://editorial.fxstreet.com/authors/TWisniewsky_XtraSmall.jpg"")",75,75,50,50,25,25, ,https://editorial.fxstreet.com/authors/TWisniewsky_XtraSmall.jpg,360,https://www.fxstreet.com/macroeconomics/central-banks/fed
"=IMAGE(""https://editorial.fxstreet.com/authors/Stefan%20Gleason_XtraSmall.jpg"")",75,75,50,50,25,25, ,https://editorial.fxstreet.com/authors/Stefan%20Gleason_XtraSmall.jpg,360,https://www.fxstreet.com/macroeconomics/central-banks/fed
"=IMAGE(""https://editorial.fxstreet.com/authors/yohay_elam_75x75_Nano.jpg"")",35,35,35,35,0,0, ,https://editorial.fxstreet.com/authors/yohay_elam_75x75_Nano.jpg,360,https://www.fxstreet.com/macroeconomics/central-banks/fed
"=IMAGE(""https://editorial.fxstreet.com/authors/Joseph%20Trevisani%2075_Nano.jpg"")",35,35,35,35,0,0, ,https://editorial.fxstreet.com/authors/Joseph%20Trevisani%2075_Nano.jpg,360,https://www.fxstreet.com/macroeconomics/central-banks/fed
"=IMAGE(""https://editorial.fxstreet.com/authors/yohay_elam_75x75_Nano.jpg"")",35,35,35,35,0,0, ,https://editorial.fxstreet.com/authors/yohay_elam_75x75_Nano.jpg,360,https://www.fxstreet.com/macroeconomics/central-banks/fed
"=IMAGE(""https://editorial.fxstreet.com/images/Macroeconomics/CentralBanks/FED/Jerome%20Powell%201Fed__XtraSmall.jpg"")",360,213,164,97,196,116, ,https://editorial.fxstreet.com/images/Macroeconomics/CentralBanks/FED/Jerome%20Powell%201Fed__XtraSmall.jpg,360,https://www.fxstreet.com/macroeconomics/central-banks/fed
"=IMAGE(""https://editorial.fxstreet.com/authors/Joseph%20Trevisani%2075_Nano.jpg"")",35,35,35,35,0,0, ,https://editorial.fxstreet.com/authors/Joseph%20Trevisani%2075_Nano.jpg,360,https://www.fxstreet.com/macroeconomics/central-banks/fed
"=IMAGE(""https://editorial.fxstreet.com/authors/yohay_elam_75x75_Nano.jpg"")",35,35,35,35,0,0, ,https://editorial.fxstreet.com/authors/yohay_elam_75x75_Nano.jpg,360,https://www.fxstreet.com/macroeconomics/central-banks/fed
"=IMAGE(""https://editorial.fxstreet.com/authors/Anthony%20Cheung%2075_XtraSmall.jpg"")",75,75,50,50,25,25, ,https://editorial.fxstreet.com/authors/Anthony%20Cheung%2075_XtraSmall.jpg,360,https://www.fxstreet.com/education/trading-guide-morning-routine-and-how-to-read-the-news-video-202102111555
"=IMAGE(""https://editorial.fxstreet.com/authors/yohay_elam_75x75_Nano.jpg"")",35,35,35,35,0,0, ,https://editorial.fxstreet.com/authors/yohay_elam_75x75_Nano.jpg,360,https://www.fxstreet.com/education/trading-guide-morning-routine-and-how-to-read-the-news-video-202102111555
"=IMAGE(""https://editorial.fxstreet.com/authors/Companies/LittleFishFX_Nano.jpg"")",35,35,35,35,0,0, ,https://editorial.fxstreet.com/authors/Companies/LittleFishFX_Nano.jpg,360,https://www.fxstreet.com/education/trading-guide-morning-routine-and-how-to-read-the-news-video-202102111555
"=IMAGE(""https://editorial.fxstreet.com/authors/bradleygilbert_Nano.jpg"")",35,35,35,35,0,0, ,https://editorial.fxstreet.com/authors/bradleygilbert_Nano.jpg,360,https://www.fxstreet.com/education/trading-guide-morning-routine-and-how-to-read-the-news-video-202102111555
"=IMAGE(""https://editorial.fxstreet.com/authors/colibriauthorimage75_Nano.jpg"")",35,35,35,35,0,0, ,https://editorial.fxstreet.com/authors/colibriauthorimage75_Nano.jpg,360,https://www.fxstreet.com/education/trading-guide-morning-routine-and-how-to-read-the-news-video-202102111555
"=IMAGE(""https://editorial.fxstreet.com/authors/colibriauthorimage75_Nano.jpg"")",35,35,35,35,0,0, ,https://editorial.fxstreet.com/authors/colibriauthorimage75_Nano.jpg,360,https://www.fxstreet.com/education/trading-guide-morning-routine-and-how-to-read-the-news-video-202102111555
"=IMAGE(""https://editorial.fxstreet.com/authors/colibriauthorimage75_XtraSmall.jpg"")",75,75,50,50,25,25, ,https://editorial.fxstreet.com/authors/colibriauthorimage75_XtraSmall.jpg,360,https://www.fxstreet.com/education/what-are-the-10-fatal-mistakes-traders-make-201612130800
"=IMAGE(""https://editorial.fxstreet.com/authors/bradleygilbert_Nano.jpg"")",35,35,35,35,0,0, ,https://editorial.fxstreet.com/authors/bradleygilbert_Nano.jpg,360,https://www.fxstreet.com/education/what-are-the-10-fatal-mistakes-traders-make-201612130800
"=IMAGE(""https://editorial.fxstreet.com/authors/colibriauthorimage75_Nano.jpg"")",35,35,35,35,0,0, ,https://editorial.fxstreet.com/authors/colibriauthorimage75_Nano.jpg,360,https://www.fxstreet.com/education/what-are-the-10-fatal-mistakes-traders-make-201612130800
"=IMAGE(""https://editorial.fxstreet.com/authors/Companies/LittleFishFX_Nano.jpg"")",35,35,35,35,0,0, ,https://editorial.fxstreet.com/authors/Companies/LittleFishFX_Nano.jpg,360,https://www.fxstreet.com/education/what-are-the-10-fatal-mistakes-traders-make-201612130800
"=IMAGE(""https://editorial.fxstreet.com/authors/yohay_elam_75x75_Nano.jpg"")",35,35,35,35,0,0, ,https://editorial.fxstreet.com/authors/yohay_elam_75x75_Nano.jpg,360,https://www.fxstreet.com/education/what-are-the-10-fatal-mistakes-traders-make-201612130800
"=IMAGE(""https://editorial.fxstreet.com/authors/colibriauthorimage75_Nano.jpg"")",35,35,35,35,0,0, ,https://editorial.fxstreet.com/authors/colibriauthorimage75_Nano.jpg,360,https://www.fxstreet.com/education/what-are-the-10-fatal-mistakes-traders-make-201612130800
"=IMAGE(""https://editorial.fxstreet.com/images/Markets/Currencies/Majors/EURUSD/MoneyEURUSD_2_XtraSmall.jpg"")",125,83,92,61,33,22, ,https://editorial.fxstreet.com/images/Markets/Currencies/Majors/EURUSD/MoneyEURUSD_2_XtraSmall.jpg,360,https://www.fxstreet.com/technical-analysis/support-resistance
"=IMAGE(""https://editorial.fxstreet.com/images/Markets/Currencies/Majors/GBPUSD/iStock-689067954_XtraSmall.jpg"")",125,83,92,61,33,22, ,https://editorial.fxstreet.com/images/Markets/Currencies/Majors/GBPUSD/iStock-689067954_XtraSmall.jpg,360,https://www.fxstreet.com/technical-analysis/support-resistance
"=IMAGE(""https://editorial.fxstreet.com/images/Markets/Commodities/Metals/Gold/gold-on-weight-scale-gm165418687-21879510_XtraSmall.jpg"")",125,83,92,61,33,22, ,https://editorial.fxstreet.com/images/Markets/Commodities/Metals/Gold/gold-on-weight-scale-gm165418687-21879510_XtraSmall.jpg,360,https://www.fxstreet.com/technical-analysis/support-resistance
"=IMAGE(""https://editorial.fxstreet.com/images/Resources/Always_On_Editors_Pick_(320x213)_XtraSmall.png"")",125,83,92,61,33,22, ,https://editorial.fxstreet.com/images/Resources/Always_On_Editors_Pick_(320x213)_XtraSmall.png,360,https://www.fxstreet.com/technical-analysis/support-resistance
"=IMAGE(""https://editorial.azureedge.net/authors/Navin-Prithyani_Nano.jpg"")",35,35,35,35,0,0, ,https://editorial.azureedge.net/authors/Navin-Prithyani_Nano.jpg,360,https://www.fxstreet.com/technical-analysis/support-resistance
"=IMAGE(""https://editorial.fxstreet.com/images/Markets/Currencies/Cryptocurrencies/keyboard-637516572906741132_XtraSmall.jpg"")",125,83,92,61,33,22, ,https://editorial.fxstreet.com/images/Markets/Currencies/Cryptocurrencies/keyboard-637516572906741132_XtraSmall.jpg,360,https://www.fxstreet.com/technical-analysis/support-resistance
"=IMAGE(""https://editorial.fxstreet.com/images/TechnicalAnalysis/Intermarket/Correlation/it-must-work-gm537868515-58464346_Small.jpg"")",320,213,328,218,-8,-5, ,https://editorial.fxstreet.com/images/TechnicalAnalysis/Intermarket/Correlation/it-must-work-gm537868515-58464346_Small.jpg,360,https://www.fxstreet.com/technical-analysis/support-resistance
"=IMAGE(""https://editorial.azureedge.net/authors/Walter%20Peters_Nano.JPG"")",35,35,35,35,0,0, ,https://editorial.azureedge.net/authors/Walter%20Peters_Nano.JPG,360,https://www.fxstreet.com/technical-analysis/support-resistance
"=IMAGE(""https://editorial.fxstreet.com/images/TechnicalAnalysis/SupportResistance/graph-lines-gm491680705-39986012_Small.jpg"")",320,204,328,209,-8,-5, ,https://editorial.fxstreet.com/images/TechnicalAnalysis/SupportResistance/graph-lines-gm491680705-39986012_Small.jpg,360,https://www.fxstreet.com/technical-analysis/support-resistance
"=IMAGE(""https://editorial.fxstreet.com/authors/Walter%20Peters_Nano.JPG"")",35,35,35,35,0,0, ,https://editorial.fxstreet.com/authors/Walter%20Peters_Nano.JPG,360,https://www.fxstreet.com/technical-analysis/support-resistance
"=IMAGE(""https://editorial.fxstreet.com/authors/Navin7575_Nano.png"")",35,35,35,35,0,0, ,https://editorial.fxstreet.com/authors/Navin7575_Nano.png,360,https://www.fxstreet.com/technical-analysis/support-resistance
"=IMAGE(""https://editorial.fxstreet.com/authors/Walter%20Peters_XtraSmall.JPG"")",75,75,50,50,25,25, ,https://editorial.fxstreet.com/authors/Walter%20Peters_XtraSmall.JPG,360,https://www.fxstreet.com/live-video/how-to-trade-support-and-resistance-naked-201609131310
"=IMAGE(""https://editorial.fxstreet.com/images/Markets/Currencies/Majors/GBPUSD/iStock-689067954_XtraSmall.jpg"")",125,83,92,61,33,22, ,https://editorial.fxstreet.com/images/Markets/Currencies/Majors/GBPUSD/iStock-689067954_XtraSmall.jpg,360,https://www.fxstreet.com/live-video/how-to-trade-support-and-resistance-naked-201609131310
"=IMAGE(""https://editorial.fxstreet.com/images/Markets/Currencies/Majors/EURUSD/MoneyEURUSD_2_XtraSmall.jpg"")",125,83,92,61,33,22, ,https://editorial.fxstreet.com/images/Markets/Currencies/Majors/EURUSD/MoneyEURUSD_2_XtraSmall.jpg,360,https://www.fxstreet.com/live-video/how-to-trade-support-and-resistance-naked-201609131310
"=IMAGE(""https://editorial.fxstreet.com/images/Markets/Commodities/Metals/Gold/gold-on-weight-scale-gm165418687-21879510_XtraSmall.jpg"")",125,83,92,61,33,22, ,https://editorial.fxstreet.com/images/Markets/Commodities/Metals/Gold/gold-on-weight-scale-gm165418687-21879510_XtraSmall.jpg,360,https://www.fxstreet.com/live-video/how-to-trade-support-and-resistance-naked-201609131310
"=IMAGE(""https://editorial.fxstreet.com/images/Markets/Currencies/Cryptocurrencies/keyboard-637516572906741132_XtraSmall.jpg"")",125,83,92,61,33,22, ,https://editorial.fxstreet.com/images/Markets/Currencies/Cryptocurrencies/keyboard-637516572906741132_XtraSmall.jpg,360,https://www.fxstreet.com/live-video/how-to-trade-support-and-resistance-naked-201609131310
"=IMAGE(""https://editorial.fxstreet.com/images/Resources/Always_On_Editors_Pick_(320x213)_XtraSmall.png"")",125,83,92,61,33,22, ,https://editorial.fxstreet.com/images/Resources/Always_On_Editors_Pick_(320x213)_XtraSmall.png,360,https://www.fxstreet.com/live-video/how-to-trade-support-and-resistance-naked-201609131310
"=IMAGE(""https://editorial.fxstreet.com/images/Markets/Currencies/Majors/USDCAD/dollars-11347249_XtraSmall.jpg"")",125,83,105,70,20,13, ,https://editorial.fxstreet.com/images/Markets/Currencies/Majors/USDCAD/dollars-11347249_XtraSmall.jpg,360,https://www.fxstreet.com/search?q=&hPP=20&idx=FxsIndexPro&p=0&dFR%5BCategory%5D%5B0%5D=Video&dFR%5BCategory%5D%5B1%5D=Premium%20Video&is_v=1
"=IMAGE(""https://editorial.fxstreet.com/images/TechnicalAnalysis/Intermarket/Correlation/greasy-gears-in-the-machine-gm503847604-82780433_XtraSmall.jpg"")",125,83,105,70,20,13, ,https://editorial.fxstreet.com/images/TechnicalAnalysis/Intermarket/Correlation/greasy-gears-in-the-machine-gm503847604-82780433_XtraSmall.jpg,360,https://www.fxstreet.com/search?q=&hPP=20&idx=FxsIndexPro&p=0&dFR%5BCategory%5D%5B0%5D=Video&dFR%5BCategory%5D%5B1%5D=Premium%20Video&is_v=1
"=IMAGE(""https://editorial.fxstreet.com/images/Markets/Currencies/Majors/NZDUSD/new-zealand-currency-background-33709642_XtraSmall.jpg"")",125,83,105,70,20,13, ,https://editorial.fxstreet.com/images/Markets/Currencies/Majors/NZDUSD/new-zealand-currency-background-33709642_XtraSmall.jpg,360,https://www.fxstreet.com/search?q=&hPP=20&idx=FxsIndexPro&p=0&dFR%5BCategory%5D%5B0%5D=Video&dFR%5BCategory%5D%5B1%5D=Premium%20Video&is_v=1
"=IMAGE(""https://editorial.fxstreet.com/images/Markets/Currencies/Majors/EURUSD/usd-eur-banknotes-58361490_XtraSmall.jpg"")",125,83,105,70,20,13, ,https://editorial.fxstreet.com/images/Markets/Currencies/Majors/EURUSD/usd-eur-banknotes-58361490_XtraSmall.jpg,360,https://www.fxstreet.com/search?q=&hPP=20&idx=FxsIndexPro&p=0&dFR%5BCategory%5D%5B0%5D=Video&dFR%5BCategory%5D%5B1%5D=Premium%20Video&is_v=1
"=IMAGE(""https://editorial.fxstreet.com/images/Markets/Currencies/Majors/NZDUSD/kiwi-dollar-62496010_XtraSmall.jpg"")",125,83,105,70,20,13, ,https://editorial.fxstreet.com/images/Markets/Currencies/Majors/NZDUSD/kiwi-dollar-62496010_XtraSmall.jpg,360,https://www.fxstreet.com/search?q=&hPP=20&idx=FxsIndexPro&p=0&dFR%5BCategory%5D%5B0%5D=Video&dFR%5BCategory%5D%5B1%5D=Premium%20Video&is_v=1
"=IMAGE(""https://editorial.fxstreet.com/images/Markets/Equities/Industries/Software/man-developing-software-637435356543561169_XtraSmall.jpg"")",125,83,105,70,20,13, ,https://editorial.fxstreet.com/images/Markets/Equities/Industries/Software/man-developing-software-637435356543561169_XtraSmall.jpg,360,https://www.fxstreet.com/search?q=&hPP=20&idx=FxsIndexPro&p=0&dFR%5BCategory%5D%5B0%5D=Video&dFR%5BCategory%5D%5B1%5D=Premium%20Video&is_v=1
"=IMAGE(""https://editorial.fxstreet.com/images/TechnicalAnalysis/SupportResistance/businessman-hand-drawing-virtual-chart-business-on-touch-screen-gm468924540-60303990_XtraSmall.jpg"")",125,89,98,70,27,19, ,https://editorial.fxstreet.com/images/TechnicalAnalysis/SupportResistance/businessman-hand-drawing-virtual-chart-business-on-touch-screen-gm468924540-60303990_XtraSmall.jpg,360,https://www.fxstreet.com/search?q=&hPP=20&idx=FxsIndexPro&p=0&dFR%5BCategory%5D%5B0%5D=Video&dFR%5BCategory%5D%5B1%5D=Premium%20Video&is_v=1
"=IMAGE(""https://editorial.fxstreet.com/images/TechnicalAnalysis/ChartPatterns/Chartism/financial-analysis-6085333_XtraSmall.jpg"")",125,83,105,70,20,13, ,https://editorial.fxstreet.com/images/TechnicalAnalysis/ChartPatterns/Chartism/financial-analysis-6085333_XtraSmall.jpg,360,https://www.fxstreet.com/search?q=&hPP=20&idx=FxsIndexPro&p=0&dFR%5BCategory%5D%5B0%5D=Video&dFR%5BCategory%5D%5B1%5D=Premium%20Video&is_v=1
"=IMAGE(""https://editorial.fxstreet.com/images/Markets/Currencies/Majors/EURUSD/MoneyEURUSD_2_XtraSmall.jpg"")",125,83,95,63,30,20, ,https://editorial.fxstreet.com/images/Markets/Currencies/Majors/EURUSD/MoneyEURUSD_2_XtraSmall.jpg,360,https://www.fxstreet.com/search?q=&hPP=20&idx=FxsIndexPro&p=0&dFR%5BCategory%5D%5B0%5D=Video&dFR%5BCategory%5D%5B1%5D=Premium%20Video&is_v=1
"=IMAGE(""https://editorial.fxstreet.com/images/Markets/Currencies/Majors/GBPUSD/iStock-689067954_XtraSmall.jpg"")",125,83,95,63,30,20, ,https://editorial.fxstreet.com/images/Markets/Currencies/Majors/GBPUSD/iStock-689067954_XtraSmall.jpg,360,https://www.fxstreet.com/search?q=&hPP=20&idx=FxsIndexPro&p=0&dFR%5BCategory%5D%5B0%5D=Video&dFR%5BCategory%5D%5B1%5D=Premium%20Video&is_v=1
"=IMAGE(""https://editorial.fxstreet.com/images/Breaking/breaking-news_XtraSmall.jpg"")",125,125,95,95,30,30, ,https://editorial.fxstreet.com/images/Breaking/breaking-news_XtraSmall.jpg,360,https://www.fxstreet.com/search?q=&hPP=20&idx=FxsIndexPro&p=0&dFR%5BCategory%5D%5B0%5D=Video&dFR%5BCategory%5D%5B1%5D=Premium%20Video&is_v=1
"=IMAGE(""https://editorial.fxstreet.com/images/Avalanche/Avalanche_XtraSmall.jpg"")",125,125,95,95,30,30, ,https://editorial.fxstreet.com/images/Avalanche/Avalanche_XtraSmall.jpg,360,https://www.fxstreet.com/search?q=&hPP=20&idx=FxsIndexPro&p=0&dFR%5BCategory%5D%5B0%5D=Video&dFR%5BCategory%5D%5B1%5D=Premium%20Video&is_v=1
"=IMAGE(""https://editorial.fxstreet.com/images/TechnicalAnalysis/ChartPatterns/Candlesticks/digital-tablet-with-stock-charts-30235834_XtraSmall.jpg"")",125,83,105,70,20,13, ,https://editorial.fxstreet.com/images/TechnicalAnalysis/ChartPatterns/Candlesticks/digital-tablet-with-stock-charts-30235834_XtraSmall.jpg,360,https://www.fxstreet.com/search?q=&hPP=20&idx=FxsIndexPro&p=0&dFR%5BCategory%5D%5B0%5D=Video&dFR%5BCategory%5D%5B1%5D=Premium%20Video&is_v=1
"=IMAGE(""https://editorial.fxstreet.com/images/Markets/Currencies/Majors/EURUSD/european-union-currency-5219766_XtraSmall.jpg"")",125,83,105,70,20,13, ,https://editorial.fxstreet.com/images/Markets/Currencies/Majors/EURUSD/european-union-currency-5219766_XtraSmall.jpg,360,https://www.fxstreet.com/search?q=&hPP=20&idx=FxsIndexPro&p=0&dFR%5BCategory%5D%5B0%5D=Video&dFR%5BCategory%5D%5B1%5D=Premium%20Video&is_v=1
"=IMAGE(""https://editorial.fxstreet.com/images/Macroeconomics/EconomicIndicator/EconomicHealth/Manufacturing/production-line-workers-gm519937869-50154370_Nano.jpg"")",70,47,74,50,-4,-3, ,https://editorial.fxstreet.com/images/Macroeconomics/EconomicIndicator/EconomicHealth/Manufacturing/production-line-workers-gm519937869-50154370_Nano.jpg,360,https://www.fxstreet.com/search?q=&hPP=20&idx=FxsIndexPro&p=0&dFR%5BCategory%5D%5B0%5D=Video&dFR%5BCategory%5D%5B1%5D=Premium%20Video&is_v=1
"=IMAGE(""https://editorial.fxstreet.com/images/Markets/Currencies/Cryptocurrencies/Coins/Ripple/ripple_XtraSmall.jpg"")",125,125,95,95,30,30, ,https://editorial.fxstreet.com/images/Markets/Currencies/Cryptocurrencies/Coins/Ripple/ripple_XtraSmall.jpg,360,https://www.fxstreet.com/search?q=&hPP=20&idx=FxsIndexPro&p=0&dFR%5BCategory%5D%5B0%5D=Video&dFR%5BCategory%5D%5B1%5D=Premium%20Video&is_v=1
"=IMAGE(""https://editorial.fxstreet.com/images/Markets/Currencies/Majors/NZDUSD/new-zealand-dollar-closeup-28405768_Nano.jpg"")",75,49,77,50,-2,-1, ,https://editorial.fxstreet.com/images/Markets/Currencies/Majors/NZDUSD/new-zealand-dollar-closeup-28405768_Nano.jpg,360,https://www.fxstreet.com/search?q=&hPP=20&idx=FxsIndexPro&p=0&dFR%5BCategory%5D%5B0%5D=Video&dFR%5BCategory%5D%5B1%5D=Premium%20Video&is_v=1
"=IMAGE(""https://editorial.fxstreet.com/images/Markets/Currencies/Majors/EURUSD/money-59004818_Nano.jpg"")",75,50,75,50,0,0, ,https://editorial.fxstreet.com/images/Markets/Currencies/Majors/EURUSD/money-59004818_Nano.jpg,360,https://www.fxstreet.com/search?q=&hPP=20&idx=FxsIndexPro&p=0&dFR%5BCategory%5D%5B0%5D=Video&dFR%5BCategory%5D%5B1%5D=Premium%20Video&is_v=1
"=IMAGE(""https://editorial.fxstreet.com/images/Macroeconomics/Countries/Europe/Eurozone_countries/Germany/the-victory-column-siegessaule-with-german-flag-berlin-germany-72135281_Nano.jpg"")",70,47,74,50,-4,-3, ,https://editorial.fxstreet.com/images/Macroeconomics/Countries/Europe/Eurozone_countries/Germany/the-victory-column-siegessaule-with-german-flag-berlin-germany-72135281_Nano.jpg,360,https://www.fxstreet.com/search?q=&hPP=20&idx=FxsIndexPro&p=0&dFR%5BCategory%5D%5B0%5D=Video&dFR%5BCategory%5D%5B1%5D=Premium%20Video&is_v=1
"=IMAGE(""https://editorial.fxstreet.com/images/Markets/Currencies/Majors/USDCAD/canadian-dollar-closeup-29758764_Nano.jpg"")",75,49,77,50,-2,-1, ,https://editorial.fxstreet.com/images/Markets/Currencies/Majors/USDCAD/canadian-dollar-closeup-29758764_Nano.jpg,360,https://www.fxstreet.com/search?q=&hPP=20&idx=FxsIndexPro&p=0&dFR%5BCategory%5D%5B0%5D=Video&dFR%5BCategory%5D%5B1%5D=Premium%20Video&is_v=1
"=IMAGE(""https://editorial.fxstreet.com/images/Macroeconomics/Countries/Europe/Switzerland/zurich-64803473_Nano.jpg"")",70,47,74,50,-4,-3, ,https://editorial.fxstreet.com/images/Macroeconomics/Countries/Europe/Switzerland/zurich-64803473_Nano.jpg,360,https://www.fxstreet.com/search?q=&hPP=20&idx=FxsIndexPro&p=0&dFR%5BCategory%5D%5B0%5D=Video&dFR%5BCategory%5D%5B1%5D=Premium%20Video&is_v=1
"=IMAGE(""https://editorial.fxstreet.com/images/Macroeconomics/Events/US Elections/Joe_Biden1-637311951448658075_Nano.jpg"")",75,50,75,50,0,0, ,https://editorial.fxstreet.com/images/Macroeconomics/Events/US Elections/Joe_Biden1-637311951448658075_Nano.jpg,360,https://www.fxstreet.com/search?q=&hPP=20&idx=FxsIndexPro&p=0&dFR%5BCategory%5D%5B0%5D=Video&dFR%5BCategory%5D%5B1%5D=Premium%20Video&is_v=1
"=IMAGE(""https://editorial.fxstreet.com/authors/Slobodan%20Drvenica_75x75_XtraSmall.png"")",75,75,50,50,25,25, ,https://editorial.fxstreet.com/authors/Slobodan%20Drvenica_75x75_XtraSmall.png,360,https://www.fxstreet.com/search?q=&hPP=20&idx=FxsIndexPro&p=0&dFR%5BCategory%5D%5B0%5D=Video&dFR%5BCategory%5D%5B1%5D=Premium%20Video&is_v=1
"=IMAGE(""https://editorial.fxstreet.com/authors/Bert%20Colijn%2075_XtraSmall.png"")",75,75,50,50,25,25, ,https://editorial.fxstreet.com/authors/Bert%20Colijn%2075_XtraSmall.png,360,https://www.fxstreet.com/search?q=&hPP=20&idx=FxsIndexPro&p=0&dFR%5BCategory%5D%5B0%5D=Video&dFR%5BCategory%5D%5B1%5D=Premium%20Video&is_v=1
"=IMAGE(""https://editorial.fxstreet.com/authors/Slobodan%20Drvenica_75x75_XtraSmall.png"")",75,75,50,50,25,25, ,https://editorial.fxstreet.com/authors/Slobodan%20Drvenica_75x75_XtraSmall.png,360,https://www.fxstreet.com/search?q=&hPP=20&idx=FxsIndexPro&p=0&dFR%5BCategory%5D%5B0%5D=Video&dFR%5BCategory%5D%5B1%5D=Premium%20Video&is_v=1
"=IMAGE(""https://editorial.fxstreet.com/authors/gregor-horvat-75_XtraSmall.jpg"")",75,75,50,50,25,25, ,https://editorial.fxstreet.com/authors/gregor-horvat-75_XtraSmall.jpg,360,https://www.fxstreet.com/search?q=&hPP=20&idx=FxsIndexPro&p=0&dFR%5BCategory%5D%5B0%5D=Video&dFR%5BCategory%5D%5B1%5D=Premium%20Video&is_v=1
"=IMAGE(""https://editorial.fxstreet.com/images/Markets/Currencies/Majors/USDJPY/japanese-yen3_Nano.jpg"")",75,50,75,50,0,0, ,https://editorial.fxstreet.com/images/Markets/Currencies/Majors/USDJPY/japanese-yen3_Nano.jpg,360,https://www.fxstreet.com/search?q=&hPP=20&idx=FxsIndexPro&p=0&dFR%5BCategory%5D%5B0%5D=Video&dFR%5BCategory%5D%5B1%5D=Premium%20Video&is_v=1
"=IMAGE(""https://editorial.fxstreet.com/authors/gregor-horvat-75_XtraSmall.jpg"")",75,75,50,50,25,25, ,https://editorial.fxstreet.com/authors/gregor-horvat-75_XtraSmall.jpg,360,https://www.fxstreet.com/analysis/nice-monthly-close-there-on-the-sp500-bullish-202206011308
"=IMAGE(""https://editorial.fxstreet.com/miscelaneous/image-637896856775686972.png"")",1110,626,328,185,782,441, ,https://editorial.fxstreet.com/miscelaneous/image-637896856775686972.png,360,https://www.fxstreet.com/analysis/nice-monthly-close-there-on-the-sp500-bullish-202206011308
"=IMAGE(""https://editorial.fxstreet.com/images/Markets/Commodities/Metals/Gold/gold-on-weight-scale-gm165418687-21879510_XtraSmall.jpg"")",125,83,92,61,33,22, ,https://editorial.fxstreet.com/images/Markets/Commodities/Metals/Gold/gold-on-weight-scale-gm165418687-21879510_XtraSmall.jpg,360,https://www.fxstreet.com/analysis/nice-monthly-close-there-on-the-sp500-bullish-202206011308
"=IMAGE(""https://editorial.fxstreet.com/images/Markets/Currencies/Cryptocurrencies/keyboard-637516572906741132_XtraSmall.jpg"")",125,83,92,61,33,22, ,https://editorial.fxstreet.com/images/Markets/Currencies/Cryptocurrencies/keyboard-637516572906741132_XtraSmall.jpg,360,https://www.fxstreet.com/analysis/nice-monthly-close-there-on-the-sp500-bullish-202206011308
"=IMAGE(""https://editorial.fxstreet.com/images/Resources/Always_On_Editors_Pick_(320x213)_XtraSmall.png"")",125,83,92,61,33,22, ,https://editorial.fxstreet.com/images/Resources/Always_On_Editors_Pick_(320x213)_XtraSmall.png,360,https://www.fxstreet.com/analysis/nice-monthly-close-there-on-the-sp500-bullish-202206011308
"=IMAGE(""https://editorial.fxstreet.com/images/Markets/Currencies/Majors/EURUSD/MoneyEURUSD_2_XtraSmall.jpg"")",125,83,92,61,33,22, ,https://editorial.fxstreet.com/images/Markets/Currencies/Majors/EURUSD/MoneyEURUSD_2_XtraSmall.jpg,360,https://www.fxstreet.com/analysis/nice-monthly-close-there-on-the-sp500-bullish-202206011308
"=IMAGE(""https://editorial.fxstreet.com/images/Markets/Currencies/Majors/GBPUSD/iStock-689067954_XtraSmall.jpg"")",125,83,92,61,33,22, ,https://editorial.fxstreet.com/images/Markets/Currencies/Majors/GBPUSD/iStock-689067954_XtraSmall.jpg,360,https://www.fxstreet.com/analysis/nice-monthly-close-there-on-the-sp500-bullish-202206011308
"=IMAGE(""https://editorial.fxstreet.com/images/Macroeconomics/EconomicIndicator/EconomicHealth/GDP/Growth/businessman-calculating-tax-with-coins-at-desk-gm503897740-82845157_Nano.jpg"")",70,47,74,50,-4,-3, ,https://editorial.fxstreet.com/images/Macroeconomics/EconomicIndicator/EconomicHealth/GDP/Growth/businessman-calculating-tax-with-coins-at-desk-gm503897740-82845157_Nano.jpg,360,https://www.fxstreet.com/analysis/nice-monthly-close-there-on-the-sp500-bullish-202206011308
"=IMAGE(""https://editorial.fxstreet.com/images/Markets/Currencies/Digital Currencies/Ethereum/ethereum_2_Nano.jpg"")",75,56,67,50,8,6, ,https://editorial.fxstreet.com/images/Markets/Currencies/Digital Currencies/Ethereum/ethereum_2_Nano.jpg,360,https://www.fxstreet.com/analysis/nice-monthly-close-there-on-the-sp500-bullish-202206011308
"=IMAGE(""https://editorial.fxstreet.com/images/Markets/Currencies/Majors/USDJPY/close-up-bank-note-of-japanese-5000-yen-44653096_Nano.jpg"")",75,50,75,50,0,0, ,https://editorial.fxstreet.com/images/Markets/Currencies/Majors/USDJPY/close-up-bank-note-of-japanese-5000-yen-44653096_Nano.jpg,360,https://www.fxstreet.com/analysis/nice-monthly-close-there-on-the-sp500-bullish-202206011308
"=IMAGE(""https://editorial.fxstreet.com/images/Macroeconomics/MonetaryPolicy/FED/the-federal-reserve-building-in-washington-dc-usa-67160227_Nano.jpg"")",75,50,75,50,0,0, ,https://editorial.fxstreet.com/images/Macroeconomics/MonetaryPolicy/FED/the-federal-reserve-building-in-washington-dc-usa-67160227_Nano.jpg,360,https://www.fxstreet.com/analysis/nice-monthly-close-there-on-the-sp500-bullish-202206011308
"=IMAGE(""https://editorial.fxstreet.com/images/Markets/Currencies/Majors/NZDUSD/new-zealand-dollar-61366114_Nano.jpg"")",75,50,75,50,0,0, ,https://editorial.fxstreet.com/images/Markets/Currencies/Majors/NZDUSD/new-zealand-dollar-61366114_Nano.jpg,360,https://www.fxstreet.com/analysis/nice-monthly-close-there-on-the-sp500-bullish-202206011308
"=IMAGE(""https://editorial.fxstreet.com/images/Markets/Currencies/Cryptocurrencies/cryptos_Nano.jpg"")",75,50,75,50,0,0, ,https://editorial.fxstreet.com/images/Markets/Currencies/Cryptocurrencies/cryptos_Nano.jpg,360,https://www.fxstreet.com/analysis/nice-monthly-close-there-on-the-sp500-bullish-202206011308
"=IMAGE(""https://editorial.fxstreet.com/authors/Ivan_Brian_75x75-637460415014970981_XtraSmall.jpg"")",75,75,50,50,25,25, ,https://editorial.fxstreet.com/authors/Ivan_Brian_75x75-637460415014970981_XtraSmall.jpg,360,https://www.fxstreet.com/analysis/nice-monthly-close-there-on-the-sp500-bullish-202206011308
"=IMAGE(""https://editorial.fxstreet.com/authors/Slobodan%20Drvenica_75x75_XtraSmall.png"")",75,75,50,50,25,25, ,https://editorial.fxstreet.com/authors/Slobodan%20Drvenica_75x75_XtraSmall.png,360,https://www.fxstreet.com/analysis/nice-monthly-close-there-on-the-sp500-bullish-202206011308
"=IMAGE(""https://editorial.fxstreet.com/authors/Ivan_Brian_75x75-637460415014970981_XtraSmall.jpg"")",75,75,50,50,25,25, ,https://editorial.fxstreet.com/authors/Ivan_Brian_75x75-637460415014970981_XtraSmall.jpg,360,https://www.fxstreet.com/analysis/nice-monthly-close-there-on-the-sp500-bullish-202206011308
"=IMAGE(""https://editorial.fxstreet.com/images/Markets/Equities/SP500/wall_street_nyse2-637299021353183737_Small.jpg"")",320,213,328,216,-8,-3, ,https://editorial.fxstreet.com/images/Markets/Equities/SP500/wall_street_nyse2-637299021353183737_Small.jpg,360,https://www.fxstreet.com/amp/analysis/nice-monthly-close-there-on-the-sp500-bullish-202206011308
"=IMAGE(""https://editorial.fxstreet.com/miscelaneous/image-637896856775686972.png"")",1110,626,328,219,782,407, ,https://editorial.fxstreet.com/miscelaneous/image-637896856775686972.png,360,https://www.fxstreet.com/amp/analysis/nice-monthly-close-there-on-the-sp500-bullish-202206011308
"=IMAGE(""https://responsive.fxempire.com/width/274x90/webp-lossy-70.q50/_fximages_/logos/xm-100.png"")",274,91,70,20,204,71, ,https://responsive.fxempire.com/width/274x90/webp-lossy-70.q50/_fximages_/logos/xm-100.png,360,https://www.fxstreet.com/amp/analysis/nice-monthly-close-there-on-the-sp500-bullish-202206011308
"=IMAGE(""https://editorial.fxstreet.com/miscelaneous/NZDJPYH4_010622-637896798256074827.png"")",1710,674,328,674,1382,0, ,https://editorial.fxstreet.com/miscelaneous/NZDJPYH4_010622-637896798256074827.png,360,https://www.fxstreet.com/analysis/nzd-jpy-keeps-drifting-north-above-an-uptrend-line-202206011124
"=IMAGE(""https://editorial.fxstreet.com/authors/team_XtraSmall.png"")",74,75,50,50,24,25, ,https://editorial.fxstreet.com/authors/team_XtraSmall.png,360,https://www.fxstreet.com/analysis/nzd-jpy-keeps-drifting-north-above-an-uptrend-line-202206011124
"=IMAGE(""https://editorial.fxstreet.com/images/Markets/Currencies/Majors/GBPUSD/iStock-689067954_XtraSmall.jpg"")",125,83,92,61,33,22, ,https://editorial.fxstreet.com/images/Markets/Currencies/Majors/GBPUSD/iStock-689067954_XtraSmall.jpg,360,https://www.fxstreet.com/analysis/nzd-jpy-keeps-drifting-north-above-an-uptrend-line-202206011124
"=IMAGE(""https://editorial.fxstreet.com/images/Markets/Currencies/Majors/EURUSD/MoneyEURUSD_2_XtraSmall.jpg"")",125,83,92,61,33,22, ,https://editorial.fxstreet.com/images/Markets/Currencies/Majors/EURUSD/MoneyEURUSD_2_XtraSmall.jpg,360,https://www.fxstreet.com/analysis/nzd-jpy-keeps-drifting-north-above-an-uptrend-line-202206011124
"=IMAGE(""https://editorial.fxstreet.com/images/Markets/Currencies/Cryptocurrencies/keyboard-637516572906741132_XtraSmall.jpg"")",125,83,92,61,33,22, ,https://editorial.fxstreet.com/images/Markets/Currencies/Cryptocurrencies/keyboard-637516572906741132_XtraSmall.jpg,360,https://www.fxstreet.com/analysis/nzd-jpy-keeps-drifting-north-above-an-uptrend-line-202206011124
"=IMAGE(""https://editorial.fxstreet.com/images/Markets/Commodities/Metals/Gold/gold-on-weight-scale-gm165418687-21879510_XtraSmall.jpg"")",125,83,92,61,33,22, ,https://editorial.fxstreet.com/images/Markets/Commodities/Metals/Gold/gold-on-weight-scale-gm165418687-21879510_XtraSmall.jpg,360,https://www.fxstreet.com/analysis/nzd-jpy-keeps-drifting-north-above-an-uptrend-line-202206011124
"=IMAGE(""https://editorial.fxstreet.com/images/Markets/Currencies/Majors/USDJPY/close-up-bank-note-of-japanese-5000-yen-44653096_Nano.jpg"")",75,50,75,50,0,0, ,https://editorial.fxstreet.com/images/Markets/Currencies/Majors/USDJPY/close-up-bank-note-of-japanese-5000-yen-44653096_Nano.jpg,360,https://www.fxstreet.com/analysis/nzd-jpy-keeps-drifting-north-above-an-uptrend-line-202206011124
"=IMAGE(""https://editorial.fxstreet.com/images/Resources/Always_On_Editors_Pick_(320x213)_XtraSmall.png"")",125,83,92,61,33,22, ,https://editorial.fxstreet.com/images/Resources/Always_On_Editors_Pick_(320x213)_XtraSmall.png,360,https://www.fxstreet.com/analysis/nzd-jpy-keeps-drifting-north-above-an-uptrend-line-202206011124
"=IMAGE(""https://editorial.fxstreet.com/images/Macroeconomics/EconomicIndicator/EconomicHealth/GDP/Growth/businessman-calculating-tax-with-coins-at-desk-gm503897740-82845157_Nano.jpg"")",70,47,74,50,-4,-3, ,https://editorial.fxstreet.com/images/Macroeconomics/EconomicIndicator/EconomicHealth/GDP/Growth/businessman-calculating-tax-with-coins-at-desk-gm503897740-82845157_Nano.jpg,360,https://www.fxstreet.com/analysis/nzd-jpy-keeps-drifting-north-above-an-uptrend-line-202206011124
"=IMAGE(""https://editorial.fxstreet.com/images/Markets/Currencies/Cryptocurrencies/cryptos_Nano.jpg"")",75,50,75,50,0,0, ,https://editorial.fxstreet.com/images/Markets/Currencies/Cryptocurrencies/cryptos_Nano.jpg,360,https://www.fxstreet.com/analysis/nzd-jpy-keeps-drifting-north-above-an-uptrend-line-202206011124
"=IMAGE(""https://editorial.fxstreet.com/images/Markets/Currencies/Digital Currencies/Ethereum/ethereum_2_Nano.jpg"")",75,56,67,50,8,6, ,https://editorial.fxstreet.com/images/Markets/Currencies/Digital Currencies/Ethereum/ethereum_2_Nano.jpg,360,https://www.fxstreet.com/analysis/nzd-jpy-keeps-drifting-north-above-an-uptrend-line-202206011124
"=IMAGE(""https://editorial.fxstreet.com/images/Markets/Currencies/Majors/NZDUSD/new-zealand-dollar-61366114_Nano.jpg"")",75,50,75,50,0,0, ,https://editorial.fxstreet.com/images/Markets/Currencies/Majors/NZDUSD/new-zealand-dollar-61366114_Nano.jpg,360,https://www.fxstreet.com/analysis/nzd-jpy-keeps-drifting-north-above-an-uptrend-line-202206011124
"=IMAGE(""https://editorial.fxstreet.com/images/Macroeconomics/MonetaryPolicy/FED/the-federal-reserve-building-in-washington-dc-usa-67160227_Nano.jpg"")",75,50,75,50,0,0, ,https://editorial.fxstreet.com/images/Macroeconomics/MonetaryPolicy/FED/the-federal-reserve-building-in-washington-dc-usa-67160227_Nano.jpg,360,https://www.fxstreet.com/analysis/nzd-jpy-keeps-drifting-north-above-an-uptrend-line-202206011124
"=IMAGE(""https://editorial.fxstreet.com/authors/Ivan_Brian_75x75-637460415014970981_XtraSmall.jpg"")",75,75,50,50,25,25, ,https://editorial.fxstreet.com/authors/Ivan_Brian_75x75-637460415014970981_XtraSmall.jpg,360,https://www.fxstreet.com/analysis/nzd-jpy-keeps-drifting-north-above-an-uptrend-line-202206011124
"=IMAGE(""https://editorial.fxstreet.com/authors/Slobodan%20Drvenica_75x75_XtraSmall.png"")",75,75,50,50,25,25, ,https://editorial.fxstreet.com/authors/Slobodan%20Drvenica_75x75_XtraSmall.png,360,https://www.fxstreet.com/analysis/nzd-jpy-keeps-drifting-north-above-an-uptrend-line-202206011124
"=IMAGE(""https://editorial.fxstreet.com/authors/Ivan_Brian_75x75-637460415014970981_XtraSmall.jpg"")",75,75,50,50,25,25, ,https://editorial.fxstreet.com/authors/Ivan_Brian_75x75-637460415014970981_XtraSmall.jpg,360,https://www.fxstreet.com/analysis/nzd-jpy-keeps-drifting-north-above-an-uptrend-line-202206011124
"=IMAGE(""https://responsive.fxempire.com/width/274x90/webp-lossy-70.q50/_fximages_/logos/xm-100.png"")",274,91,70,20,204,71, ,https://responsive.fxempire.com/width/274x90/webp-lossy-70.q50/_fximages_/logos/xm-100.png,360,https://www.fxstreet.com/amp/analysis/nzd-jpy-keeps-drifting-north-above-an-uptrend-line-202206011124
"=IMAGE(""https://editorial.fxstreet.com/images/Markets/Currencies/Crosses/NZDJPY/forex-new-zealand-and-japanese-currency-pair-with-calculator-4683855_Small.jpg"")",320,213,328,216,-8,-3, ,https://editorial.fxstreet.com/images/Markets/Currencies/Crosses/NZDJPY/forex-new-zealand-and-japanese-currency-pair-with-calculator-4683855_Small.jpg,360,https://www.fxstreet.com/amp/analysis/nzd-jpy-keeps-drifting-north-above-an-uptrend-line-202206011124
"=IMAGE(""https://editorial.fxstreet.com/images/Markets/Equities/SP500/wall_street_nyse2-637299021353183737_XtraSmall.jpg"")",125,83,72,72,53,11, ,https://editorial.fxstreet.com/images/Markets/Equities/SP500/wall_street_nyse2-637299021353183737_XtraSmall.jpg,360,https://www.fxstreet.com/amp/analysis/nzd-jpy-keeps-drifting-north-above-an-uptrend-line-202206011124
"=IMAGE(""https://editorial.fxstreet.com/images/Markets/Currencies/Majors/EURUSD/european-union-currency-5219766_XtraSmall.jpg"")",125,83,72,72,53,11, ,https://editorial.fxstreet.com/images/Markets/Currencies/Majors/EURUSD/european-union-currency-5219766_XtraSmall.jpg,360,https://www.fxstreet.com/amp/analysis/nzd-jpy-keeps-drifting-north-above-an-uptrend-line-202206011124
"=IMAGE(""https://editorial.fxstreet.com/images/Markets/Currencies/Crosses/XAUUSD/gold-ingot-19143567_XtraSmall.jpg"")",125,84,72,72,53,12, ,https://editorial.fxstreet.com/images/Markets/Currencies/Crosses/XAUUSD/gold-ingot-19143567_XtraSmall.jpg,360,https://www.fxstreet.com/amp/analysis/nzd-jpy-keeps-drifting-north-above-an-uptrend-line-202206011124
"=IMAGE(""https://editorial.fxstreet.com/images/Macroeconomics/EconomicIndicator/Employment/unemployment-gm172752359-4942412_XtraSmall.jpg"")",125,83,72,72,53,11, ,https://editorial.fxstreet.com/images/Macroeconomics/EconomicIndicator/Employment/unemployment-gm172752359-4942412_XtraSmall.jpg,360,https://www.fxstreet.com/amp/analysis/nzd-jpy-keeps-drifting-north-above-an-uptrend-line-202206011124
"=IMAGE(""https://editorial.fxstreet.com/images/Markets/Currencies/Majors/USDJPY/close-up-bank-note-of-japanese-5000-yen-44653096_XtraSmall.jpg"")",125,83,72,72,53,11, ,https://editorial.fxstreet.com/images/Markets/Currencies/Majors/USDJPY/close-up-bank-note-of-japanese-5000-yen-44653096_XtraSmall.jpg,360,https://www.fxstreet.com/amp/analysis/nzd-jpy-keeps-drifting-north-above-an-uptrend-line-202206011124
"=IMAGE(""https://editorial.fxstreet.com/images/Markets/Currencies/Majors/USDJPY/yen-japones-billetes-de-banco_XtraSmall.jpg"")",125,83,72,72,53,11, ,https://editorial.fxstreet.com/images/Markets/Currencies/Majors/USDJPY/yen-japones-billetes-de-banco_XtraSmall.jpg,360,https://www.fxstreet.com/amp/analysis/nzd-jpy-keeps-drifting-north-above-an-uptrend-line-202206011124
"=IMAGE(""https://editorial.fxstreet.com/images/Macroeconomics/Countries/Europe/Eurozone_countries/Italy/roman-forum-in-rome-italy-5290419_XtraSmall.jpg"")",125,83,72,72,53,11, ,https://editorial.fxstreet.com/images/Macroeconomics/Countries/Europe/Eurozone_countries/Italy/roman-forum-in-rome-italy-5290419_XtraSmall.jpg,360,https://www.fxstreet.com/amp/analysis/nzd-jpy-keeps-drifting-north-above-an-uptrend-line-202206011124
"=IMAGE(""https://editorial.fxstreet.com/images/Macroeconomics/EconomicIndicator/EconomicHealth/GDP/Growth/businessman-calculating-tax-with-coins-at-desk-gm503897740-82845157_XtraSmall.jpg"")",125,83,72,72,53,11, ,https://editorial.fxstreet.com/images/Macroeconomics/EconomicIndicator/EconomicHealth/GDP/Growth/businessman-calculating-tax-with-coins-at-desk-gm503897740-82845157_XtraSmall.jpg,360,https://www.fxstreet.com/amp/analysis/nzd-jpy-keeps-drifting-north-above-an-uptrend-line-202206011124
"=IMAGE(""https://editorial.fxstreet.com/miscelaneous/NZDJPYH4_010622-637896798256074827.png"")",1710,674,328,129,1382,545, ,https://editorial.fxstreet.com/miscelaneous/NZDJPYH4_010622-637896798256074827.png,360,https://www.fxstreet.com/amp/analysis/nzd-jpy-keeps-drifting-north-above-an-uptrend-line-202206011124
"=IMAGE(""https://editorial.fxstreet.com/images/Markets/Currencies/Majors/NZDUSD/new-zealand-dollar-61366114_XtraSmall.jpg"")",125,83,72,72,53,11, ,https://editorial.fxstreet.com/images/Markets/Currencies/Majors/NZDUSD/new-zealand-dollar-61366114_XtraSmall.jpg,360,https://www.fxstreet.com/amp/analysis/nzd-jpy-keeps-drifting-north-above-an-uptrend-line-202206011124
"=IMAGE(""https://editorial.fxstreet.com/images/Markets/Currencies/Crosses/NZDJPY/forex-new-zealand-and-japanese-currency-pair-with-calculator-4683855_XtraSmall.jpg"")",125,83,72,72,53,11, ,https://editorial.fxstreet.com/images/Markets/Currencies/Crosses/NZDJPY/forex-new-zealand-and-japanese-currency-pair-with-calculator-4683855_XtraSmall.jpg,360,https://www.fxstreet.com/amp/analysis/nzd-jpy-keeps-drifting-north-above-an-uptrend-line-202206011124
"=IMAGE(""https://editorial.fxstreet.com/authors/Companies/BNP%20Paribas_XtraSmall.png"")",75,75,50,50,25,25, ,https://editorial.fxstreet.com/authors/Companies/BNP%20Paribas_XtraSmall.png,360,https://www.fxstreet.com/analysis/italy-the-ratio-of-new-non-performing-loans-of-nfcs-has-started-to-rise-again-202206011145
"=IMAGE(""https://editorial.fxstreet.com/images/Markets/Currencies/Majors/GBPUSD/iStock-689067954_XtraSmall.jpg"")",125,83,92,61,33,22, ,https://editorial.fxstreet.com/images/Markets/Currencies/Majors/GBPUSD/iStock-689067954_XtraSmall.jpg,360,https://www.fxstreet.com/analysis/italy-the-ratio-of-new-non-performing-loans-of-nfcs-has-started-to-rise-again-202206011145
"=IMAGE(""https://editorial.fxstreet.com/images/Markets/Currencies/Cryptocurrencies/keyboard-637516572906741132_XtraSmall.jpg"")",125,83,92,61,33,22, ,https://editorial.fxstreet.com/images/Markets/Currencies/Cryptocurrencies/keyboard-637516572906741132_XtraSmall.jpg,360,https://www.fxstreet.com/analysis/italy-the-ratio-of-new-non-performing-loans-of-nfcs-has-started-to-rise-again-202206011145
"=IMAGE(""https://editorial.fxstreet.com/miscelaneous/b-637896805726124285.png"")",584,556,328,556,256,0, ,https://editorial.fxstreet.com/miscelaneous/b-637896805726124285.png,360,https://www.fxstreet.com/analysis/italy-the-ratio-of-new-non-performing-loans-of-nfcs-has-started-to-rise-again-202206011145
"=IMAGE(""https://editorial.fxstreet.com/images/Markets/Currencies/Majors/EURUSD/MoneyEURUSD_2_XtraSmall.jpg"")",125,83,92,61,33,22, ,https://editorial.fxstreet.com/images/Markets/Currencies/Majors/EURUSD/MoneyEURUSD_2_XtraSmall.jpg,360,https://www.fxstreet.com/analysis/italy-the-ratio-of-new-non-performing-loans-of-nfcs-has-started-to-rise-again-202206011145
"=IMAGE(""https://editorial.fxstreet.com/images/Resources/Always_On_Editors_Pick_(320x213)_XtraSmall.png"")",125,83,92,61,33,22, ,https://editorial.fxstreet.com/images/Resources/Always_On_Editors_Pick_(320x213)_XtraSmall.png,360,https://www.fxstreet.com/analysis/italy-the-ratio-of-new-non-performing-loans-of-nfcs-has-started-to-rise-again-202206011145
"=IMAGE(""https://editorial.fxstreet.com/images/Markets/Currencies/Majors/USDJPY/close-up-bank-note-of-japanese-5000-yen-44653096_Nano.jpg"")",75,50,75,50,0,0, ,https://editorial.fxstreet.com/images/Markets/Currencies/Majors/USDJPY/close-up-bank-note-of-japanese-5000-yen-44653096_Nano.jpg,360,https://www.fxstreet.com/analysis/italy-the-ratio-of-new-non-performing-loans-of-nfcs-has-started-to-rise-again-202206011145
"=IMAGE(""https://editorial.fxstreet.com/images/Macroeconomics/EconomicIndicator/EconomicHealth/GDP/Growth/businessman-calculating-tax-with-coins-at-desk-gm503897740-82845157_Nano.jpg"")",70,47,74,50,-4,-3, ,https://editorial.fxstreet.com/images/Macroeconomics/EconomicIndicator/EconomicHealth/GDP/Growth/businessman-calculating-tax-with-coins-at-desk-gm503897740-82845157_Nano.jpg,360,https://www.fxstreet.com/analysis/italy-the-ratio-of-new-non-performing-loans-of-nfcs-has-started-to-rise-again-202206011145
"=IMAGE(""https://editorial.fxstreet.com/images/Markets/Currencies/Digital Currencies/Ethereum/ethereum_2_Nano.jpg"")",75,56,67,50,8,6, ,https://editorial.fxstreet.com/images/Markets/Currencies/Digital Currencies/Ethereum/ethereum_2_Nano.jpg,360,https://www.fxstreet.com/analysis/italy-the-ratio-of-new-non-performing-loans-of-nfcs-has-started-to-rise-again-202206011145
"=IMAGE(""https://editorial.fxstreet.com/images/Markets/Currencies/Cryptocurrencies/cryptos_Nano.jpg"")",75,50,75,50,0,0, ,https://editorial.fxstreet.com/images/Markets/Currencies/Cryptocurrencies/cryptos_Nano.jpg,360,https://www.fxstreet.com/analysis/italy-the-ratio-of-new-non-performing-loans-of-nfcs-has-started-to-rise-again-202206011145
"=IMAGE(""https://editorial.fxstreet.com/images/Markets/Commodities/Metals/Gold/gold-on-weight-scale-gm165418687-21879510_XtraSmall.jpg"")",125,83,92,61,33,22, ,https://editorial.fxstreet.com/images/Markets/Commodities/Metals/Gold/gold-on-weight-scale-gm165418687-21879510_XtraSmall.jpg,360,https://www.fxstreet.com/analysis/italy-the-ratio-of-new-non-performing-loans-of-nfcs-has-started-to-rise-again-202206011145
"=IMAGE(""https://editorial.fxstreet.com/images/Macroeconomics/MonetaryPolicy/FED/the-federal-reserve-building-in-washington-dc-usa-67160227_Nano.jpg"")",75,50,75,50,0,0, ,https://editorial.fxstreet.com/images/Macroeconomics/MonetaryPolicy/FED/the-federal-reserve-building-in-washington-dc-usa-67160227_Nano.jpg,360,https://www.fxstreet.com/analysis/italy-the-ratio-of-new-non-performing-loans-of-nfcs-has-started-to-rise-again-202206011145
"=IMAGE(""https://editorial.fxstreet.com/authors/Ivan_Brian_75x75-637460415014970981_XtraSmall.jpg"")",75,75,50,50,25,25, ,https://editorial.fxstreet.com/authors/Ivan_Brian_75x75-637460415014970981_XtraSmall.jpg,360,https://www.fxstreet.com/analysis/italy-the-ratio-of-new-non-performing-loans-of-nfcs-has-started-to-rise-again-202206011145
"=IMAGE(""https://editorial.fxstreet.com/images/Markets/Currencies/Majors/NZDUSD/new-zealand-dollar-61366114_Nano.jpg"")",75,50,75,50,0,0, ,https://editorial.fxstreet.com/images/Markets/Currencies/Majors/NZDUSD/new-zealand-dollar-61366114_Nano.jpg,360,https://www.fxstreet.com/analysis/italy-the-ratio-of-new-non-performing-loans-of-nfcs-has-started-to-rise-again-202206011145
"=IMAGE(""https://editorial.fxstreet.com/authors/Ivan_Brian_75x75-637460415014970981_XtraSmall.jpg"")",75,75,50,50,25,25, ,https://editorial.fxstreet.com/authors/Ivan_Brian_75x75-637460415014970981_XtraSmall.jpg,360,https://www.fxstreet.com/analysis/italy-the-ratio-of-new-non-performing-loans-of-nfcs-has-started-to-rise-again-202206011145
"=IMAGE(""https://editorial.fxstreet.com/authors/Slobodan%20Drvenica_75x75_XtraSmall.png"")",75,75,50,50,25,25, ,https://editorial.fxstreet.com/authors/Slobodan%20Drvenica_75x75_XtraSmall.png,360,https://www.fxstreet.com/analysis/italy-the-ratio-of-new-non-performing-loans-of-nfcs-has-started-to-rise-again-202206011145
"=IMAGE(""https://responsive.fxempire.com/width/274x90/webp-lossy-70.q50/_fximages_/logos/xm-100.png"")",274,91,70,20,204,71, ,https://responsive.fxempire.com/width/274x90/webp-lossy-70.q50/_fximages_/logos/xm-100.png,360,https://www.fxstreet.com/amp/analysis/italy-the-ratio-of-new-non-performing-loans-of-nfcs-has-started-to-rise-again-202206011145
"=IMAGE(""https://editorial.fxstreet.com/images/Macroeconomics/Countries/Europe/Eurozone_countries/Italy/roman-forum-in-rome-italy-5290419_Small.jpg"")",320,213,328,216,-8,-3, ,https://editorial.fxstreet.com/images/Macroeconomics/Countries/Europe/Eurozone_countries/Italy/roman-forum-in-rome-italy-5290419_Small.jpg,360,https://www.fxstreet.com/amp/analysis/italy-the-ratio-of-new-non-performing-loans-of-nfcs-has-started-to-rise-again-202206011145
"=IMAGE(""https://editorial.fxstreet.com/images/Markets/Equities/SP500/wall_street_nyse2-637299021353183737_XtraSmall.jpg"")",125,83,72,72,53,11, ,https://editorial.fxstreet.com/images/Markets/Equities/SP500/wall_street_nyse2-637299021353183737_XtraSmall.jpg,360,https://www.fxstreet.com/amp/analysis/italy-the-ratio-of-new-non-performing-loans-of-nfcs-has-started-to-rise-again-202206011145
"=IMAGE(""https://editorial.fxstreet.com/images/Markets/Currencies/Majors/EURUSD/european-union-currency-5219766_XtraSmall.jpg"")",125,83,72,72,53,11, ,https://editorial.fxstreet.com/images/Markets/Currencies/Majors/EURUSD/european-union-currency-5219766_XtraSmall.jpg,360,https://www.fxstreet.com/amp/analysis/italy-the-ratio-of-new-non-performing-loans-of-nfcs-has-started-to-rise-again-202206011145
"=IMAGE(""https://editorial.fxstreet.com/images/Markets/Currencies/Crosses/XAUUSD/gold-ingot-19143567_XtraSmall.jpg"")",125,84,72,72,53,12, ,https://editorial.fxstreet.com/images/Markets/Currencies/Crosses/XAUUSD/gold-ingot-19143567_XtraSmall.jpg,360,https://www.fxstreet.com/amp/analysis/italy-the-ratio-of-new-non-performing-loans-of-nfcs-has-started-to-rise-again-202206011145
"=IMAGE(""https://editorial.fxstreet.com/images/Macroeconomics/EconomicIndicator/Employment/unemployment-gm172752359-4942412_XtraSmall.jpg"")",125,83,72,72,53,11, ,https://editorial.fxstreet.com/images/Macroeconomics/EconomicIndicator/Employment/unemployment-gm172752359-4942412_XtraSmall.jpg,360,https://www.fxstreet.com/amp/analysis/italy-the-ratio-of-new-non-performing-loans-of-nfcs-has-started-to-rise-again-202206011145
"=IMAGE(""https://editorial.fxstreet.com/images/Markets/Currencies/Majors/USDJPY/close-up-bank-note-of-japanese-5000-yen-44653096_XtraSmall.jpg"")",125,83,72,72,53,11, ,https://editorial.fxstreet.com/images/Markets/Currencies/Majors/USDJPY/close-up-bank-note-of-japanese-5000-yen-44653096_XtraSmall.jpg,360,https://www.fxstreet.com/amp/analysis/italy-the-ratio-of-new-non-performing-loans-of-nfcs-has-started-to-rise-again-202206011145
"=IMAGE(""https://editorial.fxstreet.com/images/Markets/Currencies/Majors/USDJPY/yen-japones-billetes-de-banco_XtraSmall.jpg"")",125,83,72,72,53,11, ,https://editorial.fxstreet.com/images/Markets/Currencies/Majors/USDJPY/yen-japones-billetes-de-banco_XtraSmall.jpg,360,https://www.fxstreet.com/amp/analysis/italy-the-ratio-of-new-non-performing-loans-of-nfcs-has-started-to-rise-again-202206011145
"=IMAGE(""https://editorial.fxstreet.com/images/Macroeconomics/Countries/Europe/Eurozone_countries/Italy/roman-forum-in-rome-italy-5290419_XtraSmall.jpg"")",125,83,72,72,53,11, ,https://editorial.fxstreet.com/images/Macroeconomics/Countries/Europe/Eurozone_countries/Italy/roman-forum-in-rome-italy-5290419_XtraSmall.jpg,360,https://www.fxstreet.com/amp/analysis/italy-the-ratio-of-new-non-performing-loans-of-nfcs-has-started-to-rise-again-202206011145
"=IMAGE(""https://editorial.fxstreet.com/images/Markets/Currencies/Majors/NZDUSD/new-zealand-dollar-61366114_XtraSmall.jpg"")",125,83,72,72,53,11, ,https://editorial.fxstreet.com/images/Markets/Currencies/Majors/NZDUSD/new-zealand-dollar-61366114_XtraSmall.jpg,360,https://www.fxstreet.com/amp/analysis/italy-the-ratio-of-new-non-performing-loans-of-nfcs-has-started-to-rise-again-202206011145
"=IMAGE(""https://editorial.fxstreet.com/images/Markets/Currencies/Crosses/NZDJPY/forex-new-zealand-and-japanese-currency-pair-with-calculator-4683855_XtraSmall.jpg"")",125,83,72,72,53,11, ,https://editorial.fxstreet.com/images/Markets/Currencies/Crosses/NZDJPY/forex-new-zealand-and-japanese-currency-pair-with-calculator-4683855_XtraSmall.jpg,360,https://www.fxstreet.com/amp/analysis/italy-the-ratio-of-new-non-performing-loans-of-nfcs-has-started-to-rise-again-202206011145
"=IMAGE(""https://editorial.fxstreet.com/images/Macroeconomics/EconomicIndicator/EconomicHealth/GDP/Growth/businessman-calculating-tax-with-coins-at-desk-gm503897740-82845157_XtraSmall.jpg"")",125,83,72,72,53,11, ,https://editorial.fxstreet.com/images/Macroeconomics/EconomicIndicator/EconomicHealth/GDP/Growth/businessman-calculating-tax-with-coins-at-desk-gm503897740-82845157_XtraSmall.jpg,360,https://www.fxstreet.com/amp/analysis/italy-the-ratio-of-new-non-performing-loans-of-nfcs-has-started-to-rise-again-202206011145
"=IMAGE(""https://editorial.fxstreet.com/miscelaneous/b-637896805726124285.png"")",584,556,328,312,256,244, ,https://editorial.fxstreet.com/miscelaneous/b-637896805726124285.png,360,https://www.fxstreet.com/amp/analysis/italy-the-ratio-of-new-non-performing-loans-of-nfcs-has-started-to-rise-again-202206011145
"=IMAGE(""https://editorial.fxstreet.com/authors/TWisniewsky_XtraSmall.jpg"")",75,75,50,50,25,25, ,https://editorial.fxstreet.com/authors/TWisniewsky_XtraSmall.jpg,360,https://www.fxstreet.com/analysis/yen-weakens-again-202206011149
"=IMAGE(""https://editorial.fxstreet.com/images/Markets/Currencies/Majors/EURUSD/MoneyEURUSD_2_XtraSmall.jpg"")",125,83,92,61,33,22, ,https://editorial.fxstreet.com/images/Markets/Currencies/Majors/EURUSD/MoneyEURUSD_2_XtraSmall.jpg,360,https://www.fxstreet.com/analysis/yen-weakens-again-202206011149
"=IMAGE(""https://editorial.fxstreet.com/images/Markets/Commodities/Metals/Gold/gold-on-weight-scale-gm165418687-21879510_XtraSmall.jpg"")",125,83,92,61,33,22, ,https://editorial.fxstreet.com/images/Markets/Commodities/Metals/Gold/gold-on-weight-scale-gm165418687-21879510_XtraSmall.jpg,360,https://www.fxstreet.com/analysis/yen-weakens-again-202206011149
"=IMAGE(""https://editorial.fxstreet.com/images/Markets/Currencies/Majors/GBPUSD/iStock-689067954_XtraSmall.jpg"")",125,83,92,61,33,22, ,https://editorial.fxstreet.com/images/Markets/Currencies/Majors/GBPUSD/iStock-689067954_XtraSmall.jpg,360,https://www.fxstreet.com/analysis/yen-weakens-again-202206011149
"=IMAGE(""https://editorial.fxstreet.com/images/Markets/Currencies/Cryptocurrencies/keyboard-637516572906741132_XtraSmall.jpg"")",125,83,92,61,33,22, ,https://editorial.fxstreet.com/images/Markets/Currencies/Cryptocurrencies/keyboard-637516572906741132_XtraSmall.jpg,360,https://www.fxstreet.com/analysis/yen-weakens-again-202206011149
"=IMAGE(""https://editorial.fxstreet.com/images/Markets/Currencies/Majors/USDJPY/close-up-bank-note-of-japanese-5000-yen-44653096_Nano.jpg"")",75,50,75,50,0,0, ,https://editorial.fxstreet.com/images/Markets/Currencies/Majors/USDJPY/close-up-bank-note-of-japanese-5000-yen-44653096_Nano.jpg,360,https://www.fxstreet.com/analysis/yen-weakens-again-202206011149
"=IMAGE(""https://editorial.fxstreet.com/images/Macroeconomics/EconomicIndicator/EconomicHealth/GDP/Growth/businessman-calculating-tax-with-coins-at-desk-gm503897740-82845157_Nano.jpg"")",70,47,74,50,-4,-3, ,https://editorial.fxstreet.com/images/Macroeconomics/EconomicIndicator/EconomicHealth/GDP/Growth/businessman-calculating-tax-with-coins-at-desk-gm503897740-82845157_Nano.jpg,360,https://www.fxstreet.com/analysis/yen-weakens-again-202206011149
"=IMAGE(""https://editorial.fxstreet.com/images/Markets/Currencies/Cryptocurrencies/cryptos_Nano.jpg"")",75,50,75,50,0,0, ,https://editorial.fxstreet.com/images/Markets/Currencies/Cryptocurrencies/cryptos_Nano.jpg,360,https://www.fxstreet.com/analysis/yen-weakens-again-202206011149
"=IMAGE(""https://editorial.fxstreet.com/images/Markets/Currencies/Majors/NZDUSD/new-zealand-dollar-61366114_Nano.jpg"")",75,50,75,50,0,0, ,https://editorial.fxstreet.com/images/Markets/Currencies/Majors/NZDUSD/new-zealand-dollar-61366114_Nano.jpg,360,https://www.fxstreet.com/analysis/yen-weakens-again-202206011149
"=IMAGE(""https://editorial.fxstreet.com/images/Resources/Always_On_Editors_Pick_(320x213)_XtraSmall.png"")",125,83,92,61,33,22, ,https://editorial.fxstreet.com/images/Resources/Always_On_Editors_Pick_(320x213)_XtraSmall.png,360,https://www.fxstreet.com/analysis/yen-weakens-again-202206011149
"=IMAGE(""https://editorial.fxstreet.com/images/Markets/Currencies/Majors/EURUSD/MoneyEURUSD_2_XtraSmall.jpg"")",125,83,92,61,33,22, ,https://editorial.fxstreet.com/images/Markets/Currencies/Majors/EURUSD/MoneyEURUSD_2_XtraSmall.jpg,360,https://www.fxstreet.com/rates-charts/sp500
"=IMAGE(""https://editorial.fxstreet.com/images/Markets/Currencies/Majors/GBPUSD/iStock-689067954_XtraSmall.jpg"")",125,83,92,61,33,22, ,https://editorial.fxstreet.com/images/Markets/Currencies/Majors/GBPUSD/iStock-689067954_XtraSmall.jpg,360,https://www.fxstreet.com/rates-charts/sp500
"=IMAGE(""https://editorial.fxstreet.com/images/Markets/Commodities/Metals/Gold/gold-on-weight-scale-gm165418687-21879510_XtraSmall.jpg"")",125,83,92,61,33,22, ,https://editorial.fxstreet.com/images/Markets/Commodities/Metals/Gold/gold-on-weight-scale-gm165418687-21879510_XtraSmall.jpg,360,https://www.fxstreet.com/rates-charts/sp500
"=IMAGE(""https://editorial.fxstreet.com/images/Resources/Always_On_Editors_Pick_(320x213)_XtraSmall.png"")",125,83,92,61,33,22, ,https://editorial.fxstreet.com/images/Resources/Always_On_Editors_Pick_(320x213)_XtraSmall.png,360,https://www.fxstreet.com/rates-charts/sp500
"=IMAGE(""https://editorial.fxstreet.com/images/Macroeconomics/EconomicIndicator/EconomicHealth/Manufacturing/production-line-workers-gm519937869-50154370_Nano.jpg"")",70,47,74,50,-4,-3, ,https://editorial.fxstreet.com/images/Macroeconomics/EconomicIndicator/EconomicHealth/Manufacturing/production-line-workers-gm519937869-50154370_Nano.jpg,360,https://www.fxstreet.com/rates-charts/sp500
"=IMAGE(""https://editorial.fxstreet.com/images/Markets/Currencies/Cryptocurrencies/keyboard-637516572906741132_XtraSmall.jpg"")",125,83,92,61,33,22, ,https://editorial.fxstreet.com/images/Markets/Currencies/Cryptocurrencies/keyboard-637516572906741132_XtraSmall.jpg,360,https://www.fxstreet.com/rates-charts/sp500
"=IMAGE(""https://editorial.fxstreet.com/images/Markets/Currencies/Majors/USDJPY/japanese-yen3_Nano.jpg"")",75,50,75,50,0,0, ,https://editorial.fxstreet.com/images/Markets/Currencies/Majors/USDJPY/japanese-yen3_Nano.jpg,360,https://www.fxstreet.com/rates-charts/sp500
"=IMAGE(""https://editorial.fxstreet.com/images/Markets/Currencies/Cryptocurrencies/Crypto.com/cryptocom-150x150logo-637399977312067518_Nano.png"")",75,75,50,50,25,25, ,https://editorial.fxstreet.com/images/Markets/Currencies/Cryptocurrencies/Crypto.com/cryptocom-150x150logo-637399977312067518_Nano.png,360,https://www.fxstreet.com/rates-charts/sp500
"=IMAGE(""https://editorial.fxstreet.com/images/Markets/Currencies/Cryptocurrencies/AxieInfinity/AxieInfinity_Nano.jpg"")",75,75,50,50,25,25, ,https://editorial.fxstreet.com/images/Markets/Currencies/Cryptocurrencies/AxieInfinity/AxieInfinity_Nano.jpg,360,https://www.fxstreet.com/rates-charts/sp500
"=IMAGE(""https://editorial.fxstreet.com/images/Markets/Currencies/Majors/NZDUSD/new-zealand-dollar-closeup-28405768_Nano.jpg"")",75,49,77,50,-2,-1, ,https://editorial.fxstreet.com/images/Markets/Currencies/Majors/NZDUSD/new-zealand-dollar-closeup-28405768_Nano.jpg,360,https://www.fxstreet.com/rates-charts/sp500
"=IMAGE(""https://editorial.fxstreet.com/images/Markets/Commodities/Metals/Gold/gold-on-weight-scale-gm165418687-21879510_XtraSmall.jpg"")",125,83,92,61,33,22, ,https://editorial.fxstreet.com/images/Markets/Commodities/Metals/Gold/gold-on-weight-scale-gm165418687-21879510_XtraSmall.jpg,360,https://www.fxstreet.com/rates-charts/dowjonesindustrials
"=IMAGE(""https://editorial.fxstreet.com/images/Markets/Currencies/Majors/EURUSD/MoneyEURUSD_2_XtraSmall.jpg"")",125,83,92,61,33,22, ,https://editorial.fxstreet.com/images/Markets/Currencies/Majors/EURUSD/MoneyEURUSD_2_XtraSmall.jpg,360,https://www.fxstreet.com/rates-charts/dowjonesindustrials
"=IMAGE(""https://editorial.fxstreet.com/images/Markets/Currencies/Cryptocurrencies/keyboard-637516572906741132_XtraSmall.jpg"")",125,83,92,61,33,22, ,https://editorial.fxstreet.com/images/Markets/Currencies/Cryptocurrencies/keyboard-637516572906741132_XtraSmall.jpg,360,https://www.fxstreet.com/rates-charts/dowjonesindustrials
"=IMAGE(""https://editorial.fxstreet.com/images/Markets/Currencies/Majors/GBPUSD/iStock-689067954_XtraSmall.jpg"")",125,83,92,61,33,22, ,https://editorial.fxstreet.com/images/Markets/Currencies/Majors/GBPUSD/iStock-689067954_XtraSmall.jpg,360,https://www.fxstreet.com/rates-charts/dowjonesindustrials
"=IMAGE(""https://editorial.fxstreet.com/images/Macroeconomics/EconomicIndicator/EconomicHealth/Manufacturing/production-line-workers-gm519937869-50154370_Nano.jpg"")",70,47,74,50,-4,-3, ,https://editorial.fxstreet.com/images/Macroeconomics/EconomicIndicator/EconomicHealth/Manufacturing/production-line-workers-gm519937869-50154370_Nano.jpg,360,https://www.fxstreet.com/rates-charts/dowjonesindustrials
"=IMAGE(""https://editorial.fxstreet.com/images/Resources/Always_On_Editors_Pick_(320x213)_XtraSmall.png"")",125,83,92,61,33,22, ,https://editorial.fxstreet.com/images/Resources/Always_On_Editors_Pick_(320x213)_XtraSmall.png,360,https://www.fxstreet.com/rates-charts/dowjonesindustrials
"=IMAGE(""https://editorial.fxstreet.com/images/Markets/Currencies/Cryptocurrencies/Crypto.com/cryptocom-150x150logo-637399977312067518_Nano.png"")",75,75,50,50,25,25, ,https://editorial.fxstreet.com/images/Markets/Currencies/Cryptocurrencies/Crypto.com/cryptocom-150x150logo-637399977312067518_Nano.png,360,https://www.fxstreet.com/rates-charts/dowjonesindustrials
"=IMAGE(""https://editorial.fxstreet.com/images/Markets/Currencies/Cryptocurrencies/AxieInfinity/AxieInfinity_Nano.jpg"")",75,75,50,50,25,25, ,https://editorial.fxstreet.com/images/Markets/Currencies/Cryptocurrencies/AxieInfinity/AxieInfinity_Nano.jpg,360,https://www.fxstreet.com/rates-charts/dowjonesindustrials
"=IMAGE(""https://editorial.fxstreet.com/images/Markets/Currencies/Majors/USDJPY/japanese-yen3_Nano.jpg"")",75,50,75,50,0,0, ,https://editorial.fxstreet.com/images/Markets/Currencies/Majors/USDJPY/japanese-yen3_Nano.jpg,360,https://www.fxstreet.com/rates-charts/dowjonesindustrials
"=IMAGE(""https://editorial.fxstreet.com/images/Markets/Currencies/Majors/NZDUSD/new-zealand-dollar-closeup-28405768_Nano.jpg"")",75,49,77,50,-2,-1, ,https://editorial.fxstreet.com/images/Markets/Currencies/Majors/NZDUSD/new-zealand-dollar-closeup-28405768_Nano.jpg,360,https://www.fxstreet.com/rates-charts/dowjonesindustrials
